18 18
1 1 1 1 1 1 1 1 1 1 1 1 1 1 1 1 1 1 
1 7 7 7 7 7 1 1 1 1 1 1 1 1 1 1 1 1 
1 24 0 7 0 0 0 0 1 44 44 41 1 1 1 1 1 1 
1 7 0 7 0 7 1 0 1 43 23 41 1 21 0 1 1 1 
1 7 0 0 0 7 1 44 44 43 42 42 42 3 3 1 1 1 
1 7 7 7 7 7 1 1 1 1 1 1 1 0 0 1 1 1 
1 25 25 25 30 25 1 1 1 1 1 1 1 0 0 45 1 1 
1 25 30 25 30 30 1 1 1 27 1 29 1 1 1 45 1 1 
1 25 30 25 17 30 1 1 1 31 1 33 1 46 45 45 22 1 
1 0 30 30 30 30 1 1 0 0 26 0 1 45 46 45 1 1 
1 17 1 0 0 0 1 1 1 0 0 0 1 45 0 45 1 1 
1 0 1 1 14 1 1 1 1 32 1 34 1 45 45 45 1 1 
1 0 1 0 0 0 1 0 1 28 1 0 0 0 0 0 1 1 
1 0 1 0 1 0 1 0 1 1 1 1 1 1 1 1 1 1 
1 0 1 0 0 0 1 0 14 0 0 0 0 0 1 10 1 1 
1 0 1 1 14 1 1 0 1 0 0 0 0 0 1 0 1 1 
1 16 1 1 14 14 14 0 1 0 0 0 0 0 0 0 1 1 
1 1 1 1 1 1 1 1 1 1 1 1 1 1 1 1 1 1 
f
p  9 9 2 0 
p  10 9 2 0 
level 1
block 3 3 -1 0
block 14 5 -1 0
block 14 10 -1 0
fireball 13 15 2 0
fireball 9 15 0 0
bug 5 13 0 0
bug 3 13 2 0
tank 7 16 2 0
ball 1 15 2 0 
blob 10 15 0 0
 lightbridge 0 1 1 0
