9 9
1 1 1 1 1 1 1 1 1 
1 1 1 1 1 1 1 1 1 
1 1 1 1 1 1 1 1 1 
1 1 1 0 0 0 0 1 1 
1 1 1 0 0 128 0 1 1 
1 1 1 0 0 0 0 1 1 
1 1 1 1 1 1 1 1 1 
1 1 1 1 1 1 1 1 1 
1 1 1 1 1 1 1 1 1 
f
p  4 4 2 0 
inventory  0 0 0 0 0 0 0 0 0 
t 0 
level 1
