19 18
1 20 1 1 1 1 1 1 1 1 1 1 1 1 1 1 20 1 
20 1 1 1 1 1 1 1 1 1 1 1 1 1 1 1 1 20 
1 1 1 1 1 1 0 0 0 1 1 1 0 0 1 1 1 1 
1 1 1 1 0 0 0 0 0 1 1 0 0 0 1 1 1 1 
1 1 1 0 0 0 0 0 0 1 0 0 0 0 1 1 1 1 
1 1 0 0 0 0 0 1 201 1 0 0 1 0 1 1 1 1 
1 1 0 0 0 0 0 1 8 1 0 0 1 18 1 1 1 1 
1 1 0 0 1 0 0 1 1 1 0 0 1 1 1 1 1 1 
1 1 1 1 1 0 0 0 0 0 0 0 0 0 0 1 1 1 
1 1 0 128 0 0 0 0 0 0 0 0 0 0 0 9 10 1 
1 1 1 1 1 0 0 0 0 0 0 0 0 0 0 1 1 1 
1 1 0 0 1 0 0 1 1 1 0 0 1 1 1 1 1 1 
1 1 0 0 0 0 0 1 18 1 0 0 1 8 1 1 1 1 
1 1 0 0 0 0 0 1 0 1 0 0 1 201 1 1 1 1 
1 1 1 0 0 0 0 0 0 1 0 0 0 0 1 1 1 1 
1 1 1 1 0 0 0 0 0 1 1 0 0 0 1 1 1 1 
1 1 1 1 1 1 0 0 0 1 1 1 0 0 1 1 1 1 
20 1 1 1 1 1 1 1 1 1 1 1 1 1 1 1 1 20 
1 20 1 1 1 1 1 1 1 1 1 1 1 1 1 1 20 1 
f
p  2 9 2 0 
inventory  0 0 0 0 0 0 0 0 0 
t 0 
level 1
teeth 2 7 2 0
trap 13 6 3 13 13 -1
trap 8 12 2 8 5 -1
