46 45
1 1 1 1 1 1 1 1 1 1 1 1 1 1 1 1 1 1 1 1 1 1 1 1 1 1 1 1 1 1 1 1 1 1 1 1 1 1 1 1 1 1 1 1 1 
1 1 1 1 1 6 6 6 6 1 1 1 1 1 1 1 1 1 1 1 1 1 1 1 1 1 1 1 1 1 1 1 1 1 1 1 1 1 1 1 1 1 1 1 1 
1 1 1 1 6 6 19 19 19 6 1 1 1 1 1 1 1 1 1 1 1 1 1 1 1 1 1 1 1 1 1 1 1 1 1 1 1 1 1 1 1 1 1 1 1 
1 1 6 1 6 6 19 19 19 19 6 1 1 1 1 1 1 1 1 1 1 1 1 1 1 1 1 1 1 1 1 1 1 1 1 1 1 1 1 1 1 1 1 1 1 
1 1 6 19 19 19 19 19 19 19 6 1 1 1 1 0 0 8 0 0 1 1 1 1 1 1 1 1 1 1 1 1 1 1 1 1 1 1 1 1 1 1 1 1 1 
1 1 19 19 6 6 6 6 6 19 6 1 1 1 1 0 0 0 0 0 1 1 1 1 1 1 1 1 1 1 1 1 1 1 1 1 1 1 1 1 1 1 1 1 1 
1 1 0 128 1 1 1 1 6 6 6 1 1 1 1 0 0 1 0 0 1 1 1 1 1 1 1 1 1 1 1 1 1 1 1 1 1 1 1 1 1 1 1 1 1 
1 1 1 1 1 1 1 1 1 1 1 1 1 1 1 0 0 1 0 0 0 3 3 0 0 0 0 0 8 1 1 1 1 1 1 1 1 1 1 1 1 1 1 1 1 
1 1 1 1 1 1 1 1 1 1 1 1 1 10 9 0 0 1 1 0 0 3 3 0 0 0 0 87 0 1 1 1 1 1 1 1 1 1 1 1 1 1 1 1 1 
1 1 1 1 1 1 1 1 1 1 10 1 1 1 1 0 0 1 0 0 0 3 3 0 0 0 0 0 8 1 1 1 1 1 1 1 1 1 1 1 1 1 1 1 1 
1 1 1 1 6 6 6 6 6 6 9 6 6 6 6 0 0 1 0 0 1 1 1 1 3 1 1 1 1 1 1 1 1 1 1 1 1 1 1 1 1 1 1 1 1 
1 1 1 1 6 6 41 42 42 42 42 42 42 42 6 0 0 0 0 0 1 1 1 1 31 1 1 1 1 1 1 1 1 1 1 1 1 1 1 1 1 1 1 1 1 
1 1 1 1 1 6 41 1 1 1 1 1 1 43 6 0 0 8 0 0 1 1 1 0 0 0 1 1 1 0 0 0 1 1 1 1 1 1 1 1 1 1 1 1 1 
1 1 6 6 6 6 41 1 3 3 3 3 1 43 6 6 34 6 6 1 1 1 1 0 8 0 1 10 1 0 8 0 1 1 1 1 1 1 1 1 1 1 1 1 1 
1 1 6 41 42 42 42 1 3 22 8 3 1 43 42 42 42 6 6 1 1 1 1 1 1 34 1 9 1 34 1 1 1 1 1 1 1 1 0 0 0 0 0 1 1 
1 1 6 41 1 1 1 1 3 3 3 3 1 1 1 1 43 6 6 1 1 0 28 0 32 0 0 0 0 0 31 0 28 0 1 1 1 1 0 0 0 0 0 1 1 
1 1 6 41 1 46 45 45 0 0 0 0 7 7 7 1 43 6 6 1 1 0 8 0 1 27 0 87 0 26 1 0 8 0 1 1 1 1 0 0 0 0 0 1 1 
1 1 6 41 1 45 24 1 0 0 0 0 7 23 7 1 43 6 6 1 1 1 1 1 1 8 0 0 0 8 1 1 1 1 1 1 1 1 221 0 0 0 0 1 1 
1 1 6 41 1 45 8 1 0 0 87 0 7 8 7 1 43 6 6 1 1 0 8 0 1 27 0 0 0 26 1 0 8 0 1 1 1 1 0 0 0 0 0 1 1 
1 1 6 41 1 49 45 45 0 0 21 0 7 7 7 1 43 6 6 1 1 0 0 0 31 0 0 8 0 0 32 0 0 0 1 1 1 1 0 0 0 0 0 1 1 
1 1 6 41 1 1 1 1 0 0 0 0 1 1 1 1 43 6 6 1 1 1 1 1 1 1 33 1 33 1 1 1 1 1 1 1 1 1 0 0 0 0 0 1 1 
1 1 6 44 44 44 44 44 43 43 43 44 44 44 44 44 43 6 6 1 1 1 1 1 1 0 0 1 0 0 1 1 1 1 1 1 1 1 0 0 0 0 0 1 1 
1 1 6 6 6 6 6 6 43 8 43 43 6 6 6 6 6 6 6 1 1 1 1 1 1 8 0 1 29 8 1 1 1 1 1 1 1 1 0 0 0 0 0 1 1 
1 1 1 1 1 1 1 6 43 43 43 43 6 6 6 6 6 6 6 1 1 1 1 1 1 0 0 1 0 0 1 1 1 1 1 1 1 1 0 0 0 0 0 1 1 
1 1 1 1 1 1 1 6 6 6 34 6 6 6 6 6 6 6 6 1 1 1 1 1 1 1 1 1 1 1 1 1 1 1 0 1 1 1 0 0 0 0 0 1 1 
1 1 1 1 1 1 1 1 1 1 0 1 1 1 1 1 1 1 1 1 1 1 1 1 1 1 1 1 1 1 1 1 1 1 1 1 1 1 1 1 1 1 1 1 1 
1 1 1 1 1 1 1 1 1 0 0 0 0 0 8 1 1 1 1 1 1 1 1 1 1 1 1 1 1 1 1 1 1 1 1 1 1 1 1 1 1 1 1 1 1 
1 1 1 1 1 1 1 1 16 0 1 0 1 1 1 1 1 0 0 0 0 0 1 0 0 25 0 0 1 1 1 1 1 1 1 1 1 1 1 1 1 1 1 1 1 
1 1 1 1 1 1 1 1 1 0 0 0 0 0 1 1 1 9 1 1 10 0 1 0 0 1 0 8 1 1 1 1 1 1 1 1 1 1 1 1 1 1 1 1 1 
1 1 1 1 1 1 1 1 1 1 1 1 1 0 16 1 0 0 0 1 1 1 1 0 17 1 1 1 1 1 1 1 10 39 0 0 0 0 0 0 0 1 1 1 1 
1 1 1 1 1 1 1 1 1 0 0 0 0 0 1 1 0 0 0 1 0 0 30 0 0 1 0 0 1 1 1 1 1 1 0 0 39 39 39 0 0 1 1 1 1 
1 1 1 1 1 1 1 1 16 0 1 0 1 1 1 1 0 87 0 1 0 0 1 0 0 30 0 8 1 1 1 1 1 1 0 0 0 18 39 201 0 1 1 1 1 
1 1 1 1 1 1 1 1 1 0 0 0 0 0 0 0 0 0 0 0 0 17 1 1 1 1 1 1 1 1 1 1 1 1 0 0 39 39 39 0 0 1 1 1 1 
1 1 1 1 1 1 1 1 1 1 1 1 1 1 1 1 1 1 0 1 0 0 1 0 0 30 0 8 1 1 1 1 1 1 0 0 39 39 39 0 0 1 1 1 1 
1 1 1 1 1 1 1 1 1 1 1 1 0 0 0 0 0 0 0 1 0 0 25 0 0 1 0 0 1 1 1 1 1 1 0 0 0 18 39 201 0 1 1 1 1 
1 1 1 1 1 1 1 1 1 1 1 1 0 8 0 8 0 1 1 1 1 1 1 0 17 1 1 1 1 1 1 1 1 1 0 0 39 39 39 0 0 1 1 1 1 
1 1 1 1 1 1 1 1 1 1 1 1 0 0 7 0 0 1 1 1 1 1 1 0 0 1 0 8 1 1 1 1 1 1 1 31 1 1 1 1 1 1 1 1 1 
1 1 1 1 1 1 1 1 1 1 1 1 0 8 0 8 0 1 1 1 1 1 1 0 0 25 0 0 0 0 0 0 30 0 0 0 0 17 0 0 0 0 0 1 1 
1 1 1 1 1 1 1 1 1 1 1 1 0 0 0 0 0 1 1 1 1 1 1 1 1 1 1 1 1 1 1 1 1 1 0 1 1 1 1 1 0 1 0 1 1 
1 1 1 1 1 1 1 1 1 1 1 1 1 1 1 1 1 1 1 1 1 1 1 1 1 1 1 1 1 1 1 1 1 1 0 0 0 30 0 15 0 1 0 1 1 
1 1 1 1 1 1 1 1 1 1 1 1 1 1 1 1 1 1 1 1 1 1 1 1 1 1 1 1 1 1 1 1 1 1 1 1 1 1 1 1 1 1 0 1 1 
1 1 1 1 1 1 1 1 1 1 1 1 1 1 1 1 1 1 1 1 1 1 1 1 1 1 1 1 1 1 1 1 1 1 3 26 7 0 0 0 0 0 0 1 1 
1 1 1 1 1 1 1 1 1 1 1 1 1 1 1 1 1 1 1 1 1 1 1 1 1 1 1 1 1 1 1 1 1 1 3 0 7 0 0 20 0 87 0 1 1 
1 1 1 1 1 1 1 1 1 1 1 1 1 1 1 1 1 1 1 1 1 1 1 1 1 1 1 1 1 1 1 1 1 1 3 0 7 0 0 0 0 0 0 1 1 
1 1 1 1 1 1 1 1 1 1 1 1 1 1 1 1 1 1 1 1 1 1 1 1 1 1 1 1 1 1 1 1 1 1 0 0 0 0 0 0 0 0 0 1 1 
1 1 1 1 1 1 1 1 1 1 1 1 1 1 1 1 1 1 1 1 1 1 1 1 1 1 1 1 1 1 1 1 1 1 1 1 1 1 1 1 1 1 1 1 1 
f
p  27 17 2 0 
inventory  0 0 0 0 0 0 0 0 0 
p  26 8 2 0 
inventory  0 0 0 0 0 0 0 0 0 
p  9 18 2 0 
inventory  0 0 0 0 0 0 0 0 0 
p  17 30 2 0 
inventory  0 0 0 0 0 0 0 0 0 
p  41 43 2 0 
inventory  0 0 0 0 0 0 0 0 0 
p  38 18 3 0 
inventory  0 0 0 0 0 0 0 0 0 
p  2 6 2 0 
inventory  0 0 0 0 0 0 0 0 0 
t 0 
level 1
block 24 8 1 0
block 25 8 3 0
bug 16 6 2 0
bug 16 8 2 0
bug 16 10 2 0
block 14 36 3 0
tank 11 30 0 0
tank 11 26 0 0
block 13 35 0 0
block 15 35 2 0
block 15 37 2 0
block 13 37 2 0
fireball 39 42 3 0
ball 38 39 1 0 
glider 39 34 0 0
block 40 17 1 0
glider 42 16 0 0
spawner 39 39 1 39 42 -1
trap 37 31 1 39 31 -1
trap 37 34 0 39 34 -1
 excursionfunnel 37 19 1 0
 excursionfunnel 39 13 2 1
 excursionfunnel 43 20 3 1
 excursionfunnel 41 25 0 1
