18 18
1 1 1 1 1 1 1 1 1 1 1 1 1 1 1 1 1 1 
1 1 1 1 1 1 1 1 1 1 1 1 1 1 1 1 1 1 
1 1 1 1 20 1 1 1 1 1 1 1 1 1 1 1 1 1 
1 1 1 1 3 3 3 3 3 3 1 1 1 1 1 1 1 1 
1 1 1 1 3 3 3 3 3 3 1 1 1 18 1 1 1 1 
1 0 0 0 3 3 3 3 3 3 3 3 0 0 0 20 20 1 
1 0 128 0 3 3 3 3 3 3 3 3 0 0 0 201 10 20 
1 0 0 0 3 3 3 3 3 3 3 3 0 0 0 20 20 1 
1 1 1 1 3 3 3 3 3 3 1 1 1 1 1 1 1 1 
1 1 1 1 3 3 3 3 3 3 1 1 1 1 1 1 1 1 
1 1 1 1 1 1 3 3 1 1 1 1 1 1 1 1 1 1 
1 1 1 1 1 1 3 3 1 1 1 1 1 1 1 1 1 1 
1 1 1 1 1 1 3 3 1 1 1 1 1 1 1 1 1 1 
1 1 1 1 1 1 3 3 3 0 0 0 1 1 1 1 1 1 
1 1 1 1 1 1 3 3 3 0 0 0 1 1 1 1 1 1 
1 1 1 1 1 1 3 3 3 0 0 0 1 1 1 1 1 1 
1 1 1 1 1 1 1 1 1 1 1 1 1 1 1 1 1 1 
1 1 1 1 1 1 1 1 1 1 1 1 1 1 1 1 1 1 
f
p  1 6 2 0 
inventory  0 0 0 0 0 0 0 0 0 
t 0 
level 1
block 10 14 2 0
trap 13 4 -1 15 6 -1
 lightbridge 4 2 2 0
