9 9
1 1 1 1 1 1 1 1 1 
1 1 24 0 0 0 0 1 1 
1 1 7 7 7 1 3 1 1 
1 1 7 13 7 1 3 1 1 
1 1 7 7 7 20 0 20 1 
1 1 1 1 1 20 128 20 1 
1 1 13 0 0 13 0 20 1 
1 1 1 1 10 20 20 20 1 
1 1 1 1 1 1 1 1 1 
f
p  6 6 3 0 
inventory  0 0 0 0 0 0 0 0 0 
t 0 
level 1
