18 17
1 20 1 1 1 1 1 1 1 1 1 1 1 1 1 20 1 
20 1 1 1 1 1 1 1 1 1 1 1 1 1 1 1 20 
1 1 10 9 0 25 0 30 17 17 0 0 0 0 0 1 1 
1 1 1 1 1 1 1 1 1 1 1 1 0 0 0 1 1 
1 1 0 0 0 0 0 0 0 0 0 0 0 0 0 1 1 
1 1 0 0 0 0 0 0 8 0 0 0 0 0 0 1 1 
1 1 30 0 8 0 0 0 25 0 0 0 8 0 30 1 1 
1 1 8 0 17 0 30 0 17 0 30 0 17 0 8 1 1 
1 1 0 0 0 0 0 30 39 25 0 0 0 0 0 1 1 
1 1 39 25 0 17 0 8 17 8 0 17 0 25 39 1 1 
1 1 0 0 0 0 0 25 39 30 0 0 0 0 0 1 1 
1 1 8 0 17 0 25 0 17 0 25 0 17 0 8 1 1 
1 1 30 0 8 0 0 0 30 0 0 0 8 0 30 1 1 
1 1 0 0 0 0 0 0 8 0 0 0 0 0 0 1 1 
1 1 0 0 0 0 0 0 0 0 0 0 0 0 0 1 1 
1 1 30 1 1 25 25 25 30 25 25 25 1 1 30 1 1 
20 1 1 1 1 1 1 1 1 1 1 1 1 1 1 1 20 
1 20 1 1 1 1 1 1 1 1 1 1 1 1 1 20 1 
f
p  8 2 1 0 
inventory  0 0 0 0 0 0 0 0 0 
t 0 
level 1
teeth 6 2 1 0
 excursionfunnel 8 16 0 1
 excursionfunnel 10 16 0 0
 excursionfunnel 6 16 0 0
 excursionfunnel 2 16 0 1
 excursionfunnel 14 16 0 1
