19 17
1 20 1 1 1 1 1 1 1 1 1 1 1 1 1 20 1 
20 0 220 0 0 0 0 0 0 0 0 0 0 0 220 0 20 
1 220 1 1 1 20 20 20 20 20 20 20 1 1 1 220 1 
1 0 20 0 1 0 3 25 0 25 3 0 0 8 1 0 1 
1 0 1 128 0 0 3 25 0 25 3 0 0 0 1 0 1 
1 0 20 0 0 0 3 25 0 25 3 0 0 0 20 0 1 
1 0 20 0 0 3 3 3 3 3 3 3 0 0 20 0 1 
1 45 20 3 3 3 0 0 0 0 0 3 3 3 20 45 1 
1 45 20 30 30 3 0 17 9 17 0 3 30 30 20 45 1 
1 45 20 0 0 3 0 9 10 9 0 3 0 0 20 45 1 
1 45 20 30 30 3 0 17 9 17 0 3 30 30 20 45 1 
1 45 20 3 3 3 0 0 0 0 0 3 3 3 20 45 1 
1 0 20 0 0 3 3 3 3 3 3 3 0 0 20 0 1 
1 0 20 0 0 0 3 25 0 25 3 0 0 0 20 0 1 
1 0 1 0 0 0 3 25 0 25 3 0 0 0 1 0 1 
1 0 1 8 0 0 3 25 0 25 3 0 0 8 1 0 1 
1 220 1 1 1 20 20 20 20 20 20 20 1 1 1 220 1 
20 0 220 0 0 0 0 0 0 0 0 0 0 0 220 0 20 
1 20 1 1 1 1 1 1 1 1 1 1 1 1 1 20 1 
f
p  4 4 1 0 
inventory  0 0 0 0 0 0 0 0 0 
t 0 
level 1
yellowtank 10 9 2 0
bug 15 3 2 0
bug 15 6 2 0
iceblock 12 9 1 0
iceblock 4 9 2 0
iceblock 8 13 0 0
iceblock 8 5 2 0
spawner 9 12 0 9 12 -1
 excursionfunnel 2 3 1 1
