21 31
1 20 1 1 1 1 1 1 1 1 1 1 1 1 1 1 1 1 1 1 1 1 1 1 1 1 1 1 1 20 1 
20 1 1 1 1 1 1 1 1 1 1 1 1 1 1 1 1 1 1 1 1 1 1 1 1 1 1 1 1 1 20 
1 1 20 20 20 20 20 20 20 20 20 20 20 20 20 20 20 20 20 1 1 1 1 1 1 1 1 1 1 1 1 
1 1 20 0 0 0 0 20 0 25 0 0 0 0 3 3 8 29 20 1 1 1 1 1 1 1 1 1 1 1 1 
1 1 20 0 128 0 0 0 0 0 0 0 0 0 20 20 20 20 20 1 5 1 5 1 5 1 5 1 1 1 1 
1 1 20 0 0 0 0 13 0 0 0 0 0 0 0 0 0 0 20 5 1 5 1 5 1 5 1 1 1 1 1 
1 1 20 0 0 0 0 0 0 0 0 0 0 0 0 0 0 0 20 1 5 1 5 1 5 1 5 1 1 1 1 
1 1 20 20 20 20 20 20 20 20 20 20 20 20 20 20 20 34 20 20 20 20 20 20 20 20 20 1 1 1 20 
1 1 1 1 1 1 1 1 1 1 1 1 1 1 1 1 20 0 0 0 0 0 0 0 0 0 0 0 0 0 20 
1 5 1 5 1 1 0 17 0 17 0 17 0 17 0 1 20 0 0 0 0 0 0 0 0 0 0 25 25 25 20 
1 1 5 1 1 1 0 0 0 0 0 0 0 0 0 1 20 0 0 0 0 0 0 0 0 0 0 0 0 0 20 
1 5 1 5 1 1 0 0 0 0 13 0 0 0 0 1 20 0 0 0 0 0 0 0 0 0 0 0 0 0 20 
1 1 5 1 1 1 0 0 0 0 0 0 0 0 0 1 20 0 0 0 0 0 0 0 0 0 0 0 0 0 20 
1 5 1 5 1 1 0 221 0 221 0 221 0 221 0 1 20 0 0 0 0 34 0 0 0 0 20 3 3 3 20 
1 1 5 1 1 1 1 1 1 1 14 1 1 1 1 1 20 0 0 0 34 13 34 0 0 0 20 3 3 3 20 
1 5 1 5 1 1 1 1 1 1 34 1 1 1 1 1 20 0 0 0 0 34 0 0 0 0 20 3 3 3 20 
1 1 5 1 1 1 1 1 0 0 0 0 0 1 1 1 20 0 0 0 0 0 0 0 0 0 20 3 3 3 20 
1 5 1 5 1 1 1 1 0 0 0 0 0 1 1 1 20 0 0 0 0 0 0 0 0 0 20 0 0 0 20 
1 1 5 1 1 1 1 1 0 0 0 0 0 1 1 1 10 9 0 0 0 0 0 0 20 0 20 0 8 0 20 
20 5 1 5 1 1 1 1 1 1 1 1 1 1 1 1 20 20 20 20 20 20 20 20 20 1 20 20 20 20 20 
1 20 1 1 1 1 1 1 1 1 1 1 1 1 1 1 1 1 1 1 1 1 1 1 1 1 1 1 1 20 1 
f
p  4 5 2 0 
inventory  0 0 0 0 0 0 0 0 0 
t 0 
level 1
bug 6 9 1 0
iceblock 10 17 0 0
 excursionfunnel 7 3 1 0
 excursionfunnel 25 7 2 1
