18 20
1 1 1 1 1 1 1 1 1 1 1 1 1 1 1 1 1 1 1 1 
1 1 1 10 25 0 0 30 0 0 0 0 0 0 0 0 0 25 0 1 
1 1 1 1 1 1 1 1 1 1 1 1 1 1 1 1 0 1 1 1 
1 1 1 0 0 0 0 0 0 0 0 0 0 0 0 0 0 25 0 1 
1 1 1 0 1 1 1 1 1 1 1 1 1 1 1 1 1 1 1 1 
1 1 1 0 0 0 0 0 0 0 0 0 0 0 0 0 0 25 0 1 
1 1 1 1 1 1 1 1 1 1 1 1 1 1 1 30 1 1 1 1 
1 1 1 14 0 14 0 0 0 0 0 0 0 0 0 0 0 1 1 1 
1 1 1 14 30 14 14 14 14 14 14 14 14 14 14 14 14 1 1 1 
1 1 1 14 5 5 5 5 5 5 5 5 5 5 5 5 14 1 1 1 
1 1 1 14 5 5 5 5 5 5 5 5 5 5 5 5 14 1 1 1 
1 1 1 14 5 5 5 5 5 5 5 5 5 5 5 5 14 1 1 1 
1 1 1 14 5 5 5 5 5 5 5 5 5 5 5 5 14 1 1 1 
1 1 1 14 5 5 5 5 5 5 5 5 5 5 5 5 14 1 1 1 
1 1 1 14 5 5 5 5 5 5 5 5 5 5 5 5 14 1 1 1 
1 1 1 14 5 5 5 5 5 5 5 5 5 5 5 17 14 1 1 1 
1 1 1 14 14 14 14 14 14 14 14 14 14 14 14 14 14 1 1 1 
1 1 1 1 1 1 1 1 1 1 1 1 1 1 1 1 1 1 1 1 
f
p  15 7 2 0 
inventory  0 0 0 0 0 0 0 0 0 
t 0 
level 1
bug 4 7 2 0
 lazer 19 3 3 0
 lazer 19 1 3 0
 lazer 19 5 3 0
