18 18
1 1 1 1 1 1 1 1 1 1 1 1 1 1 1 1 1 1 
1 1 1 1 1 1 1 1 1 1 1 0 0 0 0 0 0 1 
1 1 1 1 1 1 1 1 1 1 1 1 1 1 1 1 0 1 
1 1 1 1 1 1 1 1 1 1 1 0 0 0 0 0 0 1 
1 1 1 1 10 1 1 1 1 1 1 0 1 1 1 1 1 1 
1 1 1 0 0 0 1 1 1 1 1 0 0 0 0 0 0 1 
1 1 1 0 0 0 1 1 1 1 1 1 1 1 1 1 0 1 
1 1 1 0 0 0 1 1 1 1 1 3 17 0 0 0 0 1 
1 1 1 0 0 0 1 1 1 1 1 1 1 1 1 1 1 1 
1 1 1 0 0 0 1 1 1 1 1 0 0 0 0 0 0 1 
1 1 1 1 201 1 1 1 1 1 1 30 213 213 213 0 0 1 
1 0 0 0 0 0 0 0 1 1 1 0 0 0 212 0 0 1 
1 0 18 0 0 0 0 0 1 1 1 0 0 0 212 0 0 1 
1 0 0 0 0 0 0 0 1 1 1 0 0 0 212 0 0 1 
1 0 0 0 0 0 0 0 1 1 1 213 213 213 210 0 0 1 
1 0 0 0 0 0 0 0 30 0 0 0 0 0 0 0 0 1 
1 0 0 0 0 0 0 0 30 0 0 0 0 0 0 0 0 1 
1 1 1 1 1 1 1 1 1 1 1 1 1 1 1 1 1 1 
f
p  13 12 2 0 
inventory  0 0 0 0 0 0 0 0 0 
t 0 
level 1
bug 11 1 1 0
block 3 15 3 0
trap 2 12 2 4 10 -1
