18 18
1 1 1 1 1 1 1 1 1 1 1 1 1 1 1 1 1 1 
1 1 1 1 1 1 1 1 1 1 1 1 1 1 1 1 1 1 
1 1 1 1 1 1 1 1 1 1 1 1 1 1 1 1 1 1 
1 1 1 1 1 1 1 1 1 1 1 1 1 1 1 1 1 1 
1 1 1 1 1 1 8 1 1 10 1 1 8 1 1 1 1 1 
1 1 1 1 1 1 0 0 0 9 0 0 0 1 1 1 1 1 
1 1 1 1 1 1 0 1 0 0 0 1 0 1 1 1 1 1 
1 1 1 1 1 1 41 1 0 0 0 1 41 1 1 1 1 1 
1 1 1 1 1 1 41 1 0 0 0 1 41 1 1 1 1 1 
1 1 1 1 1 1 41 1 0 0 0 1 41 1 1 1 1 1 
1 1 1 1 1 1 0 1 1 0 1 1 0 1 1 1 1 1 
1 1 1 1 1 1 0 0 0 0 0 0 0 1 1 1 1 1 
1 1 1 1 1 1 8 1 1 0 1 1 8 1 1 1 1 1 
1 1 1 1 1 1 1 1 1 1 1 1 1 1 1 1 1 1 
1 1 1 1 1 1 1 1 1 1 1 1 1 1 1 1 1 1 
1 1 1 1 1 1 1 1 1 1 1 1 1 1 1 1 1 1 
1 1 1 1 1 1 1 1 1 1 1 1 1 1 1 1 1 1 
1 1 1 1 1 1 1 1 1 1 1 1 1 1 1 1 1 1 
f
p  9 12 2 0 
inventory  0 0 0 0 0 0 0 0 0 
t 0 
level 1
param 10 6 0 0
bug 8 7 0 0
param 10 8 0 0
bug 8 9 0 0
