19 19
1 1 1 1 1 1 1 1 1 1 1 1 1 1 1 1 1 1 1 
1 1 1 1 1 1 1 1 1 1 1 1 1 1 1 1 1 1 1 
1 1 1 1 1 1 1 1 1 1 1 1 1 1 1 1 1 1 1 
1 1 1 1 1 1 1 1 1 10 1 1 1 1 1 1 1 1 1 
1 1 1 8 8 8 8 14 0 9 0 0 3 14 0 17 1 1 1 
1 1 1 8 0 0 8 14 0 0 0 0 3 14 0 0 1 1 1 
1 1 1 8 0 0 8 14 0 0 0 0 3 14 0 0 1 1 1 
1 1 1 8 0 0 8 14 0 0 0 0 3 14 17 0 1 1 1 
1 1 1 8 0 0 8 14 0 0 0 0 3 14 14 14 1 1 1 
1 1 1 8 0 0 8 14 0 0 0 0 3 3 3 3 1 1 1 
1 1 1 8 0 0 8 14 0 0 0 0 0 0 0 0 1 1 1 
1 1 1 8 0 0 8 14 0 0 0 0 3 25 3 0 1 1 1 
1 1 1 8 0 0 8 14 0 0 0 3 3 30 3 3 1 1 1 
1 1 1 8 0 0 8 14 0 128 0 3 0 0 0 3 1 1 1 
1 1 1 8 8 8 8 14 0 0 0 3 0 8 0 3 1 1 1 
1 1 1 1 1 1 1 14 0 0 0 3 0 0 0 3 1 1 1 
1 1 1 1 1 1 1 1 1 1 1 3 3 3 3 3 1 1 1 
1 1 1 1 1 1 1 1 1 1 1 1 1 1 1 1 1 1 1 
1 1 1 1 1 1 1 1 1 1 1 1 1 1 1 1 1 1 1 
f
p  9 14 3 0 
inventory  0 0 0 0 0 0 0 0 0 
t 0 
level 1
bug 5 13 3 0
bug 4 5 1 0
