31 32
1 1 1 1 1 1 1 1 1 1 1 1 1 1 1 1 1 1 1 1 1 1 1 1 1 1 1 1 1 1 1 1 
1 1 1 1 1 1 1 1 1 1 1 1 1 1 1 1 1 1 1 1 1 1 1 1 1 1 1 1 1 1 1 1 
1 1 1 1 1 1 1 1 1 1 1 1 1 1 1 1 1 1 1 1 1 45 1 1 1 1 1 1 1 1 1 1 
1 1 1 1 1 1 1 1 1 45 1 1 1 1 1 1 1 1 1 46 45 45 45 45 1 1 1 1 1 1 1 1 
1 1 1 1 1 1 1 45 46 45 45 47 1 1 1 1 1 1 8 45 45 45 45 47 45 1 1 1 1 1 1 1 
1 1 1 1 1 1 1 46 45 45 47 45 1 1 1 1 1 45 49 45 45 8 45 45 45 47 1 1 1 1 1 1 
1 1 1 1 1 46 45 45 48 13 49 45 47 45 1 1 45 46 45 45 45 45 45 45 8 45 45 1 1 1 1 1 
1 1 1 1 1 45 46 45 45 47 45 45 45 45 1 1 45 45 46 45 45 45 45 45 45 45 8 1 1 1 1 1 
1 1 1 1 45 45 45 45 45 128 45 45 45 46 42 42 47 49 45 45 45 0 47 45 45 45 45 45 13 1 1 1 
1 1 1 1 1 45 49 45 47 45 46 45 48 45 1 1 49 45 45 45 45 45 45 45 45 45 48 1 1 1 1 1 
1 1 1 1 1 49 45 45 45 45 45 45 45 48 1 1 45 45 45 45 45 45 45 45 45 45 45 1 1 1 1 1 
1 1 1 1 1 1 1 45 49 45 48 45 1 1 1 1 1 45 49 45 45 45 48 8 45 48 1 1 1 1 1 1 
1 1 1 1 1 1 1 49 45 45 45 48 1 1 1 1 1 1 45 45 8 49 45 45 48 1 1 1 1 1 1 1 
1 1 1 1 1 1 1 1 1 45 1 1 1 1 1 1 1 1 1 49 45 47 8 45 1 1 1 1 1 1 1 1 
1 1 1 1 1 1 1 1 1 1 1 1 1 1 1 1 1 1 1 1 1 45 1 1 1 1 1 1 1 1 1 1 
1 1 1 1 1 1 1 1 1 1 1 1 1 1 1 1 1 1 1 1 1 9 1 1 1 1 1 1 1 1 1 1 
1 1 1 1 1 1 1 1 1 1 1 1 1 1 1 1 1 1 1 1 1 10 1 1 1 1 1 1 1 1 1 1 
1 1 1 1 1 1 1 1 46 45 47 1 1 1 1 1 1 1 1 1 1 1 1 1 1 1 1 1 1 1 1 1 
1 1 1 1 1 1 1 46 45 45 45 47 1 1 1 1 1 1 1 1 1 1 1 1 1 1 1 1 1 1 1 1 
1 1 1 1 1 1 46 45 45 45 45 45 47 1 1 1 1 1 1 1 46 45 47 1 1 1 1 1 1 1 1 1 
1 1 1 1 1 46 45 45 45 45 45 45 45 47 1 1 1 1 1 0 48 46 45 0 1 1 1 1 1 1 1 1 
1 1 1 1 46 45 45 45 45 48 45 45 45 45 47 1 1 1 46 45 0 49 0 45 45 1 1 1 1 1 1 1 
1 1 1 1 45 45 45 45 48 13 49 45 45 45 45 45 45 45 48 45 45 13 45 45 47 1 1 1 1 1 1 1 
1 1 1 1 49 45 45 45 47 49 45 45 0 45 48 1 1 1 45 45 0 47 0 49 45 1 1 1 1 1 1 1 
1 1 1 1 1 49 45 45 45 47 46 45 45 48 1 1 1 1 1 0 45 45 45 0 1 1 1 1 1 1 1 1 
1 1 1 1 1 1 49 45 45 45 45 45 48 1 1 1 1 1 1 1 49 45 48 1 1 1 1 1 1 1 1 1 
1 1 1 1 1 1 1 49 45 45 45 48 1 1 1 1 1 1 1 1 1 1 1 1 1 1 1 1 1 1 1 1 
1 1 1 1 1 1 1 1 49 45 48 1 1 1 1 1 1 1 1 1 1 1 1 1 1 1 1 1 1 1 1 1 
1 1 1 1 1 1 1 1 1 1 1 1 1 1 1 1 1 1 1 1 1 1 1 1 1 1 1 1 1 1 1 1 
1 1 1 1 1 1 1 1 1 1 1 1 1 1 1 1 1 1 1 1 1 1 1 1 1 1 1 1 1 1 1 1 
1 1 1 1 1 1 1 1 1 1 1 1 1 1 1 1 1 1 1 1 1 1 1 1 1 1 1 1 1 1 1 1 
f
p  21 8 2 0 
inventory  0 0 0 0 0 0 0 0 0 
t 0 
level 1
