18 18
1 1 1 1 1 1 1 1 1 1 1 1 1 1 1 1 1 1 
1 3 3 3 3 3 3 3 3 3 3 3 3 3 3 3 3 1 
1 3 3 0 0 0 0 3 3 3 3 0 0 3 0 3 3 1 
1 3 0 8 0 0 1 0 3 3 0 0 0 1 8 0 3 1 
1 3 0 0 0 0 0 0 3 3 0 0 0 0 0 0 0 1 
1 3 0 0 0 0 0 0 3 3 3 3 0 3 0 0 3 1 
1 3 0 1 0 0 0 3 3 3 3 3 3 3 0 3 3 1 
1 3 0 0 0 3 3 3 0 0 0 0 0 3 3 3 3 1 
1 0 0 3 3 3 3 3 0 128 1 0 0 3 3 3 3 1 
1 3 3 3 3 3 3 3 0 0 0 0 3 3 3 3 3 1 
1 3 3 3 3 3 3 3 3 0 0 3 3 3 3 0 3 1 
1 3 3 0 3 0 3 3 3 3 3 3 1 0 3 0 3 1 
1 3 0 1 0 0 0 3 3 3 0 0 0 3 3 0 3 1 
1 3 0 0 0 0 0 3 3 0 1 0 3 3 1 0 3 1 
1 3 0 8 0 1 0 3 3 0 0 3 3 0 0 9 3 1 
1 3 3 0 0 0 0 3 3 3 3 3 0 0 9 10 3 1 
1 3 3 3 3 3 3 3 3 3 3 3 3 3 3 3 3 1 
1 1 1 1 1 1 1 1 1 1 1 1 1 1 1 1 1 1 
f
p  8 8 2 0 
inventory  0 0 0 0 0 0 0 0 0 
t 0 
level 1
block 5 4 3 0
