18 18
1 1 1 1 1 1 1 1 1 1 1 1 1 1 1 1 1 1 
1 1 1 1 1 1 1 1 1 1 1 1 1 1 1 1 1 1 
1 1 1 0 0 0 1 1 1 1 1 1 1 1 1 1 1 1 
1 1 1 0 0 0 45 45 45 45 45 45 45 1 1 1 1 1 
1 10 3 0 0 0 45 45 45 45 45 45 45 1 1 1 1 1 
1 1 1 0 0 0 45 45 45 45 45 45 45 1 1 1 1 1 
1 1 1 0 0 0 1 45 45 45 45 45 45 1 1 1 1 1 
1 1 1 1 1 1 1 45 45 45 45 45 45 1 1 1 1 1 
1 1 1 1 1 1 1 45 45 45 45 45 45 1 1 1 1 1 
1 1 1 1 1 1 1 45 45 45 45 45 45 1 1 1 1 1 
1 1 1 1 1 1 1 45 45 45 45 45 45 1 0 0 0 1 
1 1 1 1 1 1 1 45 45 45 45 45 45 45 0 0 0 1 
1 1 1 1 1 1 1 45 45 45 45 45 45 45 0 128 0 1 
1 1 1 1 1 1 1 45 45 45 45 45 45 45 0 0 0 1 
1 1 1 1 1 1 1 1 1 1 1 1 1 1 0 0 0 1 
1 1 1 1 1 1 1 1 1 1 1 1 1 1 1 1 1 1 
1 1 1 1 1 1 1 1 1 1 1 1 1 1 1 1 1 1 
1 1 1 1 1 1 1 1 1 1 1 1 1 1 1 1 1 1 
f
p  15 11 2 0 
inventory  0 0 0 0 0 0 0 0 0 
t 0 
level 1
block 15 13 3 0
