18 18
1 1 1 1 1 1 1 1 1 1 1 1 1 1 1 1 1 1 
1 3 3 3 3 3 3 3 3 3 3 3 3 3 3 3 3 1 
1 3 3 3 0 0 3 3 3 3 3 3 3 3 3 0 0 1 
1 3 3 3 0 0 3 3 3 3 0 0 128 3 3 0 0 1 
1 3 3 3 3 3 3 3 3 3 0 0 0 1 3 0 0 1 
1 3 3 3 0 3 3 3 3 3 3 3 3 3 3 3 3 1 
1 3 3 1 0 1 1 3 3 3 3 3 3 3 3 3 3 1 
1 3 3 0 0 0 1 3 3 3 3 3 3 1 3 3 3 1 
1 3 3 0 0 0 0 0 3 3 0 0 0 1 1 3 3 1 
1 3 3 0 0 0 1 0 3 3 0 0 0 1 1 3 3 1 
1 3 3 1 3 3 3 3 3 3 3 1 3 1 3 3 3 1 
1 3 3 3 3 3 3 3 3 3 3 3 3 3 3 3 3 1 
1 3 3 3 3 3 3 3 3 3 3 3 3 3 3 3 3 1 
1 3 3 0 10 0 3 3 3 3 1 0 0 0 0 0 0 1 
1 3 3 0 0 0 3 0 0 0 0 0 0 1 3 3 1 1 
1 3 3 3 3 3 3 3 3 3 3 3 3 3 3 3 1 1 
1 3 3 3 3 3 3 3 3 3 3 3 3 3 3 3 1 1 
1 1 1 1 1 1 1 1 1 1 1 1 1 1 1 1 1 1 
f
p  10 3 2 0 
inventory  0 0 0 0 0 0 0 0 0 
t 0 
level 1
block 11 4 2 0
block 16 3 2 0
