68 70
1 1 1 1 1 1 1 1 1 1 1 1 1 1 1 1 1 1 1 1 1 1 1 1 1 1 1 1 1 1 1 1 1 1 1 1 1 1 1 1 1 1 1 1 1 1 1 1 1 1 1 1 1 1 1 1 1 1 1 1 1 1 1 1 1 1 1 1 1 1 
1 1 1 1 1 1 1 1 0 14 14 14 0 1 1 1 1 1 1 1 1 1 1 1 1 1 1 1 1 1 1 1 1 1 1 8 8 1 1 1 1 1 1 1 1 1 1 1 1 1 1 1 1 1 1 1 1 1 1 1 1 1 1 1 1 1 1 1 1 1 
1 1 1 1 1 1 1 1 0 1 1 1 0 1 1 1 1 1 1 1 1 1 1 1 1 0 0 0 0 1 1 1 1 0 0 8 8 1 1 1 1 1 1 30 25 30 25 30 25 1 1 1 1 1 1 1 1 1 1 1 1 1 1 1 1 1 1 1 1 1 
1 1 1 1 1 1 0 0 0 0 0 0 0 0 0 1 1 1 1 1 1 1 1 1 1 0 1 1 41 1 1 1 1 0 1 1 1 1 1 1 1 0 0 25 30 25 30 25 30 1 1 1 1 1 1 1 1 1 1 1 1 1 1 1 1 1 1 1 1 1 
1 1 1 1 1 0 0 0 0 0 0 0 0 0 0 0 1 1 1 1 1 1 1 1 1 0 1 1 41 1 1 1 1 0 1 1 1 1 1 1 1 0 1 30 25 8 8 30 25 1 1 1 1 1 1 1 1 1 1 1 1 1 1 1 1 1 1 1 1 1 
1 1 1 1 1 0 0 0 0 0 0 0 0 0 0 0 1 1 1 1 1 1 1 1 1 0 1 20 0 0 0 0 0 0 20 1 1 8 8 1 1 0 1 25 30 8 8 25 30 1 1 1 1 0 0 0 0 0 0 0 0 0 0 0 1 1 1 1 1 1 
1 1 1 1 1 0 0 0 0 0 0 0 0 0 0 0 1 1 1 1 1 1 1 1 20 0 1 1 1 1 1 1 1 0 1 1 1 8 8 1 1 0 1 30 25 30 25 30 25 1 1 1 1 0 3 3 3 3 3 3 3 3 3 0 1 1 1 1 1 1 
1 1 1 1 1 1 0 0 0 0 0 0 0 0 0 1 1 1 1 1 1 1 1 1 0 0 20 1 1 1 1 1 1 0 1 1 1 1 0 1 1 87 1 25 30 25 30 25 30 1 1 1 1 3 3 1 3 1 1 1 3 1 3 3 1 1 1 1 1 1 
1 1 1 1 1 1 1 1 0 1 1 1 0 1 1 1 1 1 1 1 1 1 1 1 0 0 0 1 1 1 1 3 3 0 3 1 1 1 0 1 1 0 1 1 1 1 1 0 1 1 1 1 1 3 1 1 0 0 1 0 0 1 1 3 1 1 1 1 1 1 
1 1 0 0 0 0 14 14 0 1 1 1 0 14 14 0 1 1 1 1 1 1 1 1 0 1 0 1 1 1 1 3 20 0 0 0 0 0 0 20 1 0 1 1 1 1 1 0 0 0 0 0 0 0 0 0 0 0 0 0 0 0 0 0 0 14 0 1 1 1 
1 1 0 1 1 1 1 1 1 1 1 1 1 1 1 0 1 1 1 1 20 1 1 1 0 1 0 1 1 1 1 1 1 1 1 1 1 1 0 1 1 0 1 1 1 1 1 1 1 1 1 1 1 3 1 1 0 1 1 1 0 1 1 3 1 20 0 20 1 1 
1 1 0 1 1 1 1 1 1 1 1 1 1 1 1 0 1 1 1 20 0 0 0 0 0 20 0 0 16 1 1 1 1 1 0 16 3 3 0 1 1 0 0 0 0 0 0 0 0 0 30 25 1 3 3 1 0 1 17 1 0 1 3 3 1 20 17 20 1 1 
1 1 0 1 1 0 0 0 0 0 1 1 1 0 0 0 1 1 1 1 0 1 1 1 0 1 0 1 1 1 1 1 1 1 1 1 3 3 0 1 1 0 1 1 1 1 1 1 1 1 1 30 1 0 3 1 0 1 30 1 0 1 3 0 1 20 0 20 1 1 
1 1 0 1 1 0 1 1 1 0 1 1 1 0 1 1 1 1 1 1 0 1 16 0 0 20 0 0 0 0 0 0 0 1 1 1 3 3 0 1 1 0 0 0 0 0 1 1 1 1 1 25 1 0 3 3 0 0 0 0 0 3 3 0 1 1 0 0 0 1 
1 1 0 1 1 0 1 0 0 0 0 0 0 0 0 0 1 1 1 1 0 1 1 1 0 1 0 1 1 1 1 1 0 1 1 1 1 1 0 1 1 1 1 1 1 14 1 1 1 1 1 30 1 0 3 1 0 0 87 0 0 1 3 0 1 1 1 1 0 1 
1 1 0 1 1 0 1 0 0 0 0 0 0 0 0 0 1 1 1 1 0 1 1 1 20 1 0 1 1 1 0 0 0 1 1 1 1 1 0 1 1 0 17 0 0 17 0 0 17 0 1 25 1 0 3 0 1 0 0 0 1 0 3 0 1 0 0 0 0 1 
1 1 0 1 1 0 1 0 1 1 1 1 1 1 1 0 1 1 1 1 0 1 1 1 1 1 20 1 1 1 0 1 0 1 1 1 1 1 0 1 1 1 1 1 1 1 1 1 1 1 1 30 1 0 3 0 1 0 17 0 1 0 3 0 1 0 1 1 1 1 
1 1 0 1 1 0 1 0 1 1 1 1 1 1 1 0 1 1 1 1 0 1 1 1 1 1 1 1 1 1 0 1 0 1 1 1 1 1 0 0 0 0 0 0 0 0 0 0 0 0 30 25 1 0 3 0 1 0 0 0 1 0 3 0 1 0 1 0 0 1 
1 1 0 1 1 0 1 0 1 1 1 1 1 0 7 7 7 0 1 1 0 0 87 0 1 1 1 1 1 8 0 1 0 1 1 1 1 1 1 1 1 1 1 1 1 1 1 1 1 1 1 1 1 0 3 0 1 1 1 1 1 0 3 0 1 0 0 0 0 1 
1 1 0 1 1 0 1 0 1 1 1 1 1 0 7 7 7 0 1 1 20 1 1 0 1 1 1 1 1 1 1 8 0 8 1 1 1 41 42 42 42 42 42 42 42 42 42 42 42 42 42 42 42 0 3 1 0 0 0 0 0 1 3 0 1 1 1 1 1 1 
1 1 0 1 1 0 0 0 0 0 0 1 1 0 7 7 7 0 1 1 1 1 0 0 0 0 0 0 1 1 1 1 1 1 1 1 1 41 1 1 1 1 1 1 1 1 1 1 1 1 1 1 1 0 3 3 3 3 3 3 3 3 3 0 1 1 1 1 1 1 
1 1 0 1 1 1 1 0 1 1 0 1 1 0 7 7 7 0 1 1 1 1 0 0 0 0 0 0 1 1 1 1 1 1 1 1 1 41 1 1 1 1 1 1 1 1 1 1 1 1 1 1 1 0 0 0 0 0 0 0 0 0 0 0 1 1 1 1 1 1 
1 1 0 1 1 1 1 0 1 1 0 1 1 1 1 0 1 1 1 1 1 1 0 0 0 17 0 0 25 30 1 1 1 1 1 1 1 41 1 1 1 1 1 1 1 1 1 1 1 1 1 1 1 1 1 1 1 1 43 1 1 1 1 1 1 1 1 1 1 1 
1 1 0 0 1 1 1 0 1 1 0 1 1 1 1 0 1 1 1 1 1 1 0 0 0 0 0 0 1 25 1 1 1 1 1 1 1 41 1 1 1 1 1 1 1 1 1 1 1 1 1 1 1 1 1 1 1 1 43 1 1 1 1 1 1 1 1 1 1 1 
1 1 1 0 1 1 1 0 0 0 0 0 0 0 0 0 0 1 1 1 1 1 0 0 0 16 0 0 1 30 1 1 1 1 1 1 1 41 1 1 1 1 3 3 3 3 3 3 3 3 3 3 3 3 3 3 1 1 43 1 1 1 1 1 1 1 1 1 1 1 
1 1 1 0 1 1 1 0 1 1 0 1 1 1 1 1 0 1 1 1 1 1 1 1 1 1 1 1 1 25 1 1 1 1 1 1 1 41 1 1 1 1 3 3 3 3 3 3 3 3 3 3 3 3 3 3 1 1 43 1 1 1 1 1 1 1 1 1 1 1 
1 1 1 0 1 1 1 0 1 1 0 1 1 1 1 1 0 1 1 1 1 1 1 1 1 1 1 1 1 30 1 1 1 1 1 1 1 41 1 1 1 1 3 3 44 44 44 44 44 44 44 44 44 44 44 44 44 44 43 1 1 1 1 1 1 1 1 1 1 1 
1 1 1 0 1 1 1 0 1 1 0 1 1 0 0 3 3 3 0 0 1 1 8 8 8 8 8 8 1 25 1 41 42 42 42 42 42 42 1 1 1 1 1 3 43 1 1 1 1 1 1 1 1 1 1 1 1 1 1 1 1 1 1 1 1 1 1 1 1 1 
1 1 1 0 1 1 1 0 1 1 0 1 1 0 0 3 3 3 0 0 0 0 0 0 0 0 0 0 25 30 1 41 1 1 1 1 1 1 1 1 1 1 43 3 43 1 1 1 1 1 1 1 1 1 1 1 1 1 1 1 1 1 1 1 1 1 1 1 1 1 
1 1 1 0 1 1 1 0 1 1 0 0 0 0 0 3 3 3 0 0 1 1 1 1 1 1 1 1 1 1 1 41 1 1 1 1 1 1 1 1 1 1 43 3 43 1 1 1 1 1 1 1 1 1 1 1 1 1 1 1 1 1 1 1 1 1 1 1 1 1 
1 1 1 0 1 1 1 0 1 1 1 1 1 0 0 3 3 3 0 0 1 1 1 1 1 1 1 1 1 1 1 41 1 1 1 1 1 1 1 1 1 1 43 3 43 1 1 1 1 1 1 1 1 1 1 1 1 1 1 1 1 1 1 1 1 1 1 1 1 1 
1 1 1 0 1 1 1 0 1 1 1 1 1 1 1 1 0 1 1 1 1 1 1 41 42 42 42 42 42 42 42 42 1 1 1 1 44 44 44 44 44 44 43 3 43 1 1 1 1 1 1 1 1 1 1 1 1 1 1 1 1 1 1 1 1 1 1 1 1 1 
1 1 1 0 1 1 1 0 1 1 1 1 1 1 1 1 0 1 1 1 1 1 1 41 1 1 1 1 1 1 1 1 1 1 1 1 43 3 3 3 3 3 3 3 43 1 1 3 3 3 0 3 0 3 0 3 0 11 3 3 3 3 3 3 3 3 1 1 1 1 
1 1 1 0 1 1 1 0 0 0 0 0 0 0 0 0 0 1 1 1 1 1 1 41 1 1 1 1 1 1 1 1 1 1 1 1 43 3 44 44 44 44 44 44 43 1 1 3 3 0 3 0 3 0 1 0 1 3 0 3 3 3 3 3 3 3 1 1 1 1 
1 1 1 0 1 1 1 1 1 1 1 1 1 1 1 1 1 1 1 1 1 1 1 41 1 1 1 41 42 42 42 42 42 42 1 1 43 3 43 1 1 1 1 1 1 1 1 3 3 3 0 3 1 3 0 3 3 3 1 0 3 3 3 3 3 3 1 1 1 1 
1 1 1 0 1 1 1 1 1 1 1 1 1 1 1 1 1 1 1 1 1 1 1 41 1 1 1 41 1 1 1 1 1 43 1 1 43 3 43 1 1 1 1 1 1 1 1 3 3 3 3 0 0 3 3 3 3 0 3 0 3 3 3 3 3 3 1 1 1 1 
1 1 1 0 0 0 0 0 1 1 1 1 1 1 1 1 1 1 1 1 1 1 1 41 1 0 0 0 0 0 0 0 1 43 1 1 43 3 1 1 1 1 1 1 1 1 1 3 3 3 0 3 3 1 128 3 0 1 3 3 3 3 3 3 3 3 1 1 1 1 
1 1 20 20 20 20 20 14 20 20 20 20 20 20 20 1 1 1 1 1 1 1 1 41 1 0 8 0 0 0 8 0 1 43 3 1 43 3 43 1 1 1 1 1 1 1 1 3 3 0 3 0 3 3 1 3 0 3 0 3 1 3 3 3 3 3 1 1 1 1 
1 1 20 0 0 0 0 0 0 0 0 0 0 0 20 1 1 1 1 1 1 1 1 41 1 0 0 1 1 1 0 0 1 43 3 1 43 3 43 1 1 1 1 1 1 1 1 3 3 3 0 3 3 3 3 3 1 3 3 0 3 3 3 3 3 3 1 1 1 1 
1 1 20 0 1 1 1 1 1 1 1 1 1 0 20 1 1 1 1 1 1 1 1 41 1 0 0 25 0 1 0 0 1 43 3 1 43 3 43 1 1 1 1 1 1 1 1 3 3 3 3 3 1 3 3 1 3 3 3 11 3 3 3 3 3 3 1 1 1 1 
1 1 20 0 0 0 0 0 0 0 0 0 0 0 20 1 1 1 1 1 1 1 1 44 44 0 0 1 1 1 0 0 1 43 3 3 43 3 43 1 1 1 1 1 1 1 1 3 3 1 3 3 3 0 3 17 0 3 1 3 3 3 3 3 3 3 1 1 1 1 
1 1 20 20 20 20 20 20 20 14 20 20 20 20 20 1 1 1 1 1 1 1 1 1 1 0 8 0 0 0 8 0 1 43 3 3 43 3 43 1 1 1 1 1 1 1 1 3 3 3 3 3 0 3 3 1 3 0 3 0 3 3 3 3 3 3 1 1 1 1 
1 1 1 0 0 0 0 0 0 0 1 1 1 1 1 1 1 1 1 1 1 1 1 1 1 0 0 0 0 0 0 0 1 43 3 1 43 3 43 1 1 1 1 1 1 3 3 3 3 3 1 3 3 0 3 3 3 3 0 3 3 3 3 3 3 3 3 3 1 1 
1 1 1 0 1 1 1 1 1 1 1 1 1 1 1 1 1 1 1 1 1 1 1 1 1 1 1 1 41 1 1 1 1 43 3 1 43 3 43 1 1 1 1 1 1 3 3 3 3 3 3 1 1 3 0 3 3 3 3 3 3 3 3 3 3 3 3 3 1 1 
1 1 1 0 1 1 1 1 1 1 1 1 1 1 1 1 1 1 1 1 1 1 1 1 1 1 1 1 41 1 1 1 1 1 1 1 43 3 43 1 1 1 1 1 1 3 3 3 3 3 3 3 3 3 30 3 3 3 3 3 3 3 3 3 3 3 3 3 1 1 
1 1 1 0 1 1 1 1 1 1 1 1 1 1 1 1 1 1 1 1 1 1 1 1 1 1 1 1 44 44 44 44 44 44 44 44 43 3 43 1 1 1 1 1 1 3 3 3 0 0 0 0 0 0 0 3 3 3 0 0 0 0 0 0 0 3 3 3 1 1 
1 1 1 0 1 1 1 1 1 1 1 1 1 1 1 1 1 1 1 1 1 1 1 1 1 1 1 1 1 1 1 1 1 1 1 1 1 3 43 1 1 1 1 1 1 3 3 3 0 1 1 1 1 1 0 3 3 3 0 1 1 1 1 1 0 3 3 3 1 1 
1 1 1 0 1 1 1 1 1 1 1 1 1 1 1 1 44 44 44 44 44 44 44 44 44 44 44 44 44 44 44 44 44 44 44 44 1 3 43 1 1 1 1 1 1 3 3 3 0 1 0 0 0 0 0 3 3 0 0 1 0 0 1 1 0 3 3 3 1 1 
1 1 1 0 1 1 1 1 1 1 1 1 1 1 1 1 3 3 3 3 3 3 3 3 3 3 3 3 3 3 3 3 3 3 3 3 3 3 43 1 1 1 1 1 1 3 3 3 0 1 0 0 0 0 0 3 3 3 3 1 0 0 1 0 0 3 3 3 1 1 
1 1 1 0 1 1 1 1 1 1 1 1 1 1 1 1 3 3 1 44 44 44 44 44 44 44 44 44 44 44 44 44 44 44 44 44 44 44 43 1 1 1 1 1 1 3 3 3 0 1 0 0 0 0 0 3 3 3 1 1 0 0 1 0 0 3 3 3 1 1 
1 1 1 0 1 1 1 1 1 1 1 1 1 1 1 1 3 3 1 1 1 1 1 1 1 1 1 1 1 1 1 1 1 1 1 1 1 1 1 1 1 0 0 0 30 3 3 3 0 1 1 1 1 1 0 3 3 3 0 1 0 0 0 0 0 3 3 3 1 1 
1 1 1 0 1 1 1 0 0 0 0 1 1 1 1 1 3 3 1 1 1 1 1 1 1 1 1 1 1 1 1 1 1 1 1 1 1 1 1 1 1 0 1 1 1 3 3 3 0 0 0 0 0 0 0 3 3 3 0 0 0 0 0 0 0 3 3 3 1 1 
1 1 1 0 1 1 1 0 0 0 0 1 1 44 44 44 44 44 44 44 41 1 1 1 0 0 3 3 1 1 1 1 1 1 1 1 1 1 3 3 0 0 1 1 1 3 3 3 3 3 3 3 3 3 3 3 3 3 3 3 3 3 3 3 3 3 3 3 1 1 
1 1 1 0 0 87 0 0 0 26 0 1 1 43 3 3 3 3 3 3 41 0 0 0 0 0 3 3 1 1 1 1 1 1 1 1 1 1 3 3 0 87 1 1 1 3 3 3 3 3 3 3 3 3 3 3 3 3 3 3 3 3 3 3 3 3 3 3 1 1 
1 1 1 1 1 1 1 0 0 0 0 0 31 43 3 0 0 0 0 3 41 1 1 1 0 0 3 3 1 1 1 1 1 1 1 1 1 1 3 3 0 0 1 1 1 3 3 3 3 3 3 3 3 3 3 3 3 3 3 3 3 3 3 3 3 3 3 3 1 1 
1 1 1 1 1 1 1 0 0 0 0 1 1 43 3 0 1 1 0 3 41 1 1 1 0 0 3 3 1 1 1 1 1 1 1 1 0 0 3 3 0 0 1 1 1 3 3 3 0 0 0 0 0 0 0 3 3 3 0 0 0 0 0 0 0 3 3 3 1 1 
1 1 1 1 1 1 1 1 1 1 1 1 1 43 3 0 1 1 0 3 41 1 1 1 0 0 3 3 1 1 1 1 1 1 1 1 0 0 3 3 0 0 1 1 1 3 3 3 0 1 1 1 1 1 0 3 3 3 0 1 1 1 1 1 0 3 3 3 1 1 
1 1 1 1 1 1 1 1 1 1 1 1 3 43 3 0 0 0 0 3 41 1 1 1 0 0 3 3 1 1 1 1 1 1 1 1 0 0 3 3 3 0 1 1 1 3 3 3 0 1 0 17 0 1 0 3 3 3 0 0 0 0 0 1 0 3 3 3 1 1 
1 1 1 1 1 1 46 45 0 45 47 1 3 43 3 3 3 3 3 3 41 1 1 1 0 0 3 3 1 1 1 1 1 1 1 1 3 3 3 3 3 3 1 1 1 3 3 3 0 1 11 1 11 1 0 3 3 3 0 0 0 0 0 1 0 3 3 3 1 1 
1 1 1 1 1 1 0 46 45 45 45 1 3 43 42 42 42 42 42 42 42 1 1 1 0 3 3 3 3 3 3 3 3 3 3 3 3 3 3 3 3 3 1 1 1 3 3 3 0 1 43 1 41 1 0 3 3 3 0 1 1 1 1 1 0 3 3 3 1 1 
1 1 1 1 1 1 49 45 41 45 45 1 1 1 3 1 1 1 1 1 1 1 1 1 3 3 3 3 3 3 3 3 3 3 3 3 3 3 3 3 3 3 1 1 1 3 3 3 0 0 0 0 0 0 0 3 3 3 0 0 0 0 0 0 0 3 3 3 1 1 
1 1 10 9 3 0 47 45 45 45 49 0 3 3 3 1 1 1 1 1 1 1 1 1 3 3 3 3 0 0 0 0 0 0 0 0 0 0 3 3 3 3 1 1 1 3 3 3 0 0 0 0 0 0 0 3 3 3 0 0 0 0 0 0 0 3 3 3 1 1 
1 1 1 1 1 1 49 48 45 45 0 1 1 1 1 1 1 1 1 1 1 1 1 1 3 3 3 0 0 0 0 0 0 0 0 0 0 0 0 3 3 3 1 1 1 3 3 3 3 3 3 3 3 3 3 3 3 3 3 3 3 3 3 3 3 3 3 3 1 1 
1 1 1 1 1 1 1 1 1 1 1 1 1 1 1 1 1 1 1 1 1 1 1 1 1 1 1 1 1 1 1 1 1 1 1 1 1 1 1 1 1 1 1 1 1 3 3 3 3 3 3 3 3 3 3 3 3 3 3 3 3 3 3 3 3 3 3 3 1 1 
1 1 1 1 1 1 1 1 1 1 1 1 1 1 1 1 1 1 1 1 1 1 1 1 1 1 1 1 1 1 1 1 1 1 1 1 1 1 1 1 1 1 1 1 1 3 3 3 3 3 3 3 3 3 3 3 3 3 3 3 3 3 3 3 3 3 3 3 1 1 
1 1 1 1 1 1 1 1 1 1 1 1 1 1 1 1 1 1 1 1 1 1 1 1 1 1 1 1 1 1 1 1 1 1 1 1 1 1 1 1 1 1 1 1 1 1 1 1 1 1 1 1 1 1 1 1 1 1 1 1 1 1 1 1 1 1 1 1 1 1 
1 1 1 1 1 1 1 1 1 1 1 1 1 1 1 1 1 1 1 1 1 1 1 1 1 1 1 1 1 1 1 1 1 1 1 1 1 1 1 1 1 1 1 1 1 1 1 1 1 1 1 1 1 1 1 1 1 1 1 1 1 1 1 1 1 1 1 1 1 1 
1 1 1 1 1 1 1 1 1 1 1 1 1 1 1 1 1 1 1 1 1 1 1 1 1 1 1 1 1 1 1 1 1 1 1 1 1 1 1 1 1 1 1 1 1 1 1 1 1 1 1 1 1 1 1 1 1 1 1 1 1 1 1 1 1 1 1 1 1 1 
f
p  53 48 2 0 
inventory  0 0 0 0 0 0 0 0 0 
t 0 
level 1
block 50 32 -1 0
block 52 32 -1 0
block 54 32 -1 0
block 56 32 -1 0
block 49 33 -1 0
block 51 33 -1 0
block 53 33 -1 0
block 55 33 -1 0
block 58 33 -1 0
block 50 34 -1 0
block 54 34 -1 0
block 59 34 -1 0
block 51 35 -1 0
block 52 35 -1 0
block 57 35 -1 0
block 59 35 -1 0
block 50 36 -1 0
block 56 36 -1 0
block 49 37 -1 0
block 51 37 -1 0
block 56 37 -1 0
block 58 37 -1 0
block 50 38 -1 0
block 59 38 -1 0
block 53 40 -1 0
block 56 40 -1 0
block 52 41 -1 0
block 57 41 -1 0
block 59 41 -1 0
block 53 42 -1 0
block 58 42 -1 0
block 54 43 -1 0
block 52 47 -1 0
block 52 48 -1 0
block 61 48 -1 0
block 52 49 -1 0
block 63 49 -1 0
block 60 50 -1 0
block 9 52 -1 0
block 8 53 -1 0
block 9 54 -1 0
block 61 57 -1 0
block 59 58 -1 0
block 60 60 -1 0
block 11 61 -1 0
teeth 28 39 1 0
tank 38 9 1 0
tank 33 5 1 0
tank 26 8 0 0
tank 24 7 0 0
tank 21 11 3 0
tank 29 13 1 0
tank 20 14 0 0
tank 20 11 0 0
tank 28 5 3 0
tank 20 16 2 0
tank 30 17 2 0
tank 27 23 1 0
tank 32 19 2 0
glider 8 24 3 0
glider 16 28 0 0
glider 9 33 1 0
glider 12 24 3 0
glider 16 24 3 0
glider 16 32 0 0
glider 13 33 1 0
glider 7 31 2 0
glider 7 27 2 0
fireball 10 24 3 0
fireball 14 24 3 0
fireball 15 21 2 0
fireball 15 17 2 0
fireball 14 14 1 0
fireball 10 14 1 0
fireball 7 15 0 0
fireball 7 19 0 0
fireball 7 23 0 0
glider 13 7 1 0
glider 14 5 0 0
glider 13 3 3 0
glider 10 3 3 0
glider 7 3 3 0
glider 6 5 2 0
glider 10 7 1 0
glider 7 7 1 0
glider 12 6 3 0
glider 8 6 3 0
glider 5 5 0 0
glider 8 4 1 0
glider 12 4 1 0
glider 15 5 2 0
bug 10 38 3 0
bug 8 38 3 0
bug 3 39 2 0
bug 5 40 1 0
bug 8 40 1 0
bug 12 40 1 0
bug 13 38 3 0
param 10 40 1 0
param 13 39 0 0
param 11 38 3 0
param 6 38 3 0
param 4 38 3 0
param 4 40 1 0
param 7 40 1 0
