64 64
1 1 1 1 1 1 1 1 1 1 1 1 1 1 1 1 1 1 1 1 1 1 1 1 1 1 1 1 1 1 1 1 1 1 1 1 1 1 1 1 1 1 1 1 1 1 1 1 1 1 1 1 1 1 1 1 1 1 1 1 1 1 1 1 
1 1 1 1 1 1 1 1 1 1 1 1 1 1 1 1 1 1 1 1 1 1 1 1 1 1 1 1 1 1 1 1 1 1 1 1 1 1 1 1 1 1 1 1 1 1 1 1 1 1 1 1 1 1 1 1 1 1 1 1 1 1 1 1 
1 1 1 1 1 1 1 1 1 1 1 1 1 1 1 1 1 1 1 1 1 1 0 0 0 0 0 1 1 1 1 1 1 1 1 1 1 1 1 1 1 1 1 1 1 1 1 1 1 1 1 1 1 1 1 1 1 1 1 1 1 1 1 1 
1 1 1 1 1 1 1 1 1 1 1 1 1 1 1 1 1 1 1 1 1 1 0 0 0 0 0 1 1 1 1 1 1 1 1 1 1 1 1 1 1 1 1 1 1 1 1 1 1 1 1 1 1 1 1 1 1 1 1 1 1 1 1 1 
1 1 1 1 1 1 1 1 1 1 1 1 1 1 1 1 1 1 1 1 1 1 25 0 87 0 25 1 1 1 1 1 1 1 1 1 1 1 1 1 1 1 1 1 1 1 1 1 1 1 1 1 1 1 1 1 1 1 1 1 1 1 1 1 
1 1 1 1 1 1 1 1 1 1 1 1 1 1 1 1 1 1 1 1 1 1 0 0 0 0 0 1 1 1 1 1 1 1 1 1 1 1 1 1 1 1 1 1 1 1 1 1 1 1 1 1 1 1 1 1 1 1 1 1 1 1 1 1 
1 1 1 1 1 1 1 1 1 1 1 1 1 1 1 1 1 1 1 1 1 1 0 0 0 0 0 1 1 1 1 1 1 1 1 1 1 20 20 20 1 1 1 1 1 1 1 1 1 1 1 1 1 1 1 1 1 1 1 1 1 1 1 1 
1 1 1 1 1 1 1 1 1 1 1 1 1 1 1 1 1 1 1 1 1 1 1 1 25 1 1 1 1 1 1 1 1 1 1 1 1 20 1 20 1 1 1 1 1 1 1 1 1 1 1 1 1 1 1 1 1 1 1 1 1 1 1 1 
1 1 1 1 1 1 1 1 1 1 1 1 1 1 1 1 1 1 1 1 1 1 1 1 30 1 1 1 1 1 1 1 1 1 1 1 1 20 3 20 1 1 1 1 1 1 1 1 1 1 1 1 1 1 1 1 1 1 1 1 1 1 1 1 
1 1 1 1 1 1 1 1 1 1 1 1 1 1 1 0 0 0 1 1 1 1 1 1 25 1 1 1 1 1 1 1 1 1 20 20 20 20 3 20 20 20 20 1 1 1 1 1 1 1 1 1 1 1 1 1 1 1 1 1 1 1 1 1 
1 0 0 0 0 3 3 3 30 3 3 0 0 0 1 0 0 0 1 0 0 0 0 0 0 0 0 0 0 0 1 1 1 1 20 3 3 3 3 3 3 3 20 1 1 1 1 1 1 1 1 1 1 1 1 1 1 1 1 1 1 1 1 1 
1 0 1 0 0 3 3 3 30 3 3 0 0 0 25 0 0 0 1 0 0 0 0 0 0 0 0 0 0 0 1 1 1 1 20 3 3 3 3 3 3 3 20 1 1 1 1 1 1 1 1 1 1 1 1 1 1 1 1 1 1 1 1 1 
1 0 1 0 0 3 3 3 30 3 3 0 0 0 1 0 0 0 1 0 0 1 1 1 0 1 1 1 0 0 0 1 1 20 3 3 3 3 3 3 3 3 20 20 20 20 1 1 1 1 1 1 1 1 1 1 1 1 1 1 1 1 1 1 
1 0 1 0 0 3 3 3 1 3 3 1 1 1 1 0 87 0 30 0 17 1 3 1 17 1 3 1 17 0 0 25 30 25 0 3 3 3 0 3 3 3 3 3 1 20 1 1 1 1 1 1 1 1 1 1 1 1 1 1 1 1 1 1 
1 0 1 0 0 3 3 3 25 3 3 0 0 0 1 0 0 0 1 0 0 1 30 1 0 1 25 1 0 0 0 1 1 20 3 3 3 3 3 3 3 3 20 20 20 20 1 1 1 1 1 1 1 1 1 1 1 1 1 1 1 1 1 1 
1 0 1 0 0 3 3 3 25 3 3 0 0 0 30 0 0 0 1 0 0 0 0 0 0 0 0 0 0 0 1 1 1 1 20 3 3 3 3 3 3 3 20 1 1 1 1 1 1 1 1 1 1 1 1 1 1 1 1 1 1 1 1 1 
1 0 0 0 0 3 3 3 25 3 3 0 0 0 1 0 0 0 1 0 0 0 0 0 0 0 0 0 0 0 1 1 1 1 20 3 3 3 3 3 3 3 20 1 1 1 1 1 1 1 1 1 1 1 1 1 1 1 1 1 1 1 1 1 
1 1 1 1 1 1 1 1 1 1 1 1 1 1 1 0 0 0 1 1 1 1 0 1 1 1 3 1 1 1 1 1 1 1 20 20 20 3 3 3 20 20 20 1 1 1 1 1 1 1 1 1 1 1 1 1 1 1 1 1 1 1 1 1 
1 1 1 1 1 1 1 1 1 1 1 1 1 1 1 1 1 1 1 1 1 1 0 1 1 1 3 1 1 1 1 1 1 1 1 1 1 20 3 20 1 1 1 1 1 1 1 1 1 1 1 1 0 1 1 1 1 1 1 1 1 1 1 1 
1 1 1 1 1 1 1 1 1 1 1 1 1 1 1 1 1 1 1 1 1 1 0 1 1 1 3 1 1 1 1 1 1 1 1 1 1 1 0 1 1 1 1 1 1 1 1 1 1 1 1 1 3 1 1 1 1 1 1 1 1 1 1 1 
1 1 1 1 1 1 1 1 1 1 1 1 1 1 1 20 1 1 1 1 3 3 3 3 3 3 3 3 3 1 1 1 1 1 1 1 1 20 3 20 1 1 1 1 1 1 20 20 20 20 3 20 3 20 20 20 3 20 20 1 1 1 1 1 
1 0 0 3 3 3 3 3 3 3 3 3 3 3 3 0 0 1 1 1 3 8 8 3 1 1 3 1 3 1 1 1 1 1 20 20 20 3 3 3 20 20 20 1 1 1 20 3 3 3 3 3 3 3 3 3 3 3 20 1 1 1 1 1 
1 0 0 3 3 3 3 3 3 3 3 3 3 3 3 0 0 1 1 1 3 8 8 3 1 1 3 1 3 1 1 1 1 1 20 3 3 3 3 3 3 3 20 1 1 1 20 3 3 3 0 3 3 3 3 3 0 3 3 1 1 1 1 1 
1 3 3 3 3 3 3 3 3 3 3 3 3 3 3 3 3 1 1 1 3 3 3 3 1 1 3 1 3 8 1 1 1 1 20 3 3 3 3 3 3 3 20 1 1 1 20 3 3 3 3 3 3 3 3 3 3 3 20 1 1 1 1 1 
1 3 3 3 3 3 3 1 1 1 1 1 1 1 3 3 3 1 1 1 1 1 1 1 1 1 3 1 3 1 1 20 20 20 20 3 3 3 3 3 3 3 3 20 1 20 3 3 3 3 3 3 3 3 3 3 3 3 20 1 1 1 1 1 
1 3 3 3 3 3 3 1 0 0 0 0 0 1 3 3 3 1 1 1 1 1 1 20 20 1 3 1 3 1 1 20 1 3 3 3 3 3 0 3 3 3 3 3 0 3 3 3 3 3 0 3 3 3 3 3 3 3 20 1 1 1 1 1 
1 3 3 3 3 3 3 1 0 0 0 0 0 1 3 3 3 1 1 3 3 3 3 3 3 3 3 3 3 1 1 20 20 20 20 3 3 3 3 3 3 3 3 20 1 20 3 3 3 3 3 3 3 3 3 3 3 3 20 1 1 1 1 1 
1 3 3 3 3 3 3 1 0 0 0 0 0 1 3 3 3 1 1 3 8 1 1 3 3 1 3 1 1 1 1 1 1 1 20 3 3 3 3 3 3 3 20 1 1 1 20 3 3 3 30 3 1 3 3 3 0 3 3 1 1 1 1 1 
1 3 3 3 3 3 3 1 1 1 3 1 1 1 3 3 3 1 1 3 1 1 1 3 3 1 3 1 1 1 1 1 1 1 20 3 3 3 3 3 3 3 20 1 1 1 20 3 3 3 3 3 3 0 3 3 3 3 20 1 1 1 1 1 
1 3 3 3 3 3 3 3 3 3 3 3 3 3 3 3 3 1 1 3 1 1 8 3 3 3 3 1 1 1 1 1 1 1 20 20 20 20 20 20 20 20 20 1 1 1 20 20 20 20 3 20 20 3 20 20 3 20 20 1 1 1 1 1 
1 3 3 3 3 3 3 1 1 1 3 1 1 1 3 3 3 1 20 3 3 3 3 3 3 20 1 1 1 1 1 1 1 1 1 1 1 1 1 1 1 1 1 1 1 1 1 1 1 1 1 1 1 1 1 1 1 1 1 1 1 1 1 1 
1 3 3 3 3 3 3 1 3 3 3 3 3 1 1 3 1 1 20 3 3 3 3 3 3 20 1 20 0 3 0 0 0 3 3 3 3 3 3 1 1 1 1 0 0 0 0 0 1 1 1 1 1 1 1 1 1 1 1 1 1 1 1 1 
1 0 0 3 3 3 3 1 3 3 3 3 3 1 1 3 0 0 1 3 1 1 0 20 20 1 1 20 0 0 0 0 1 1 3 3 3 3 3 1 1 1 1 0 0 0 0 0 1 1 1 1 1 1 1 1 1 1 1 1 1 1 1 1 
1 0 0 3 3 3 3 3 3 3 3 3 3 1 1 3 0 0 1 3 1 1 3 1 1 1 1 20 0 3 0 0 1 1 3 3 3 3 3 1 1 0 0 0 0 1 0 0 1 1 1 1 1 1 1 1 1 1 1 1 1 1 1 1 
1 1 1 1 1 1 1 1 1 1 0 1 1 1 1 3 0 0 0 3 1 1 3 1 1 1 1 20 0 3 3 3 1 1 3 3 3 3 3 1 1 0 1 0 0 0 0 0 1 1 1 1 1 1 1 1 1 1 1 1 1 1 1 1 
1 1 1 1 1 1 1 1 1 0 0 1 1 1 1 3 0 0 1 1 1 1 3 1 1 1 1 1 0 1 1 1 1 1 3 3 3 3 3 3 3 0 1 0 0 0 0 0 1 1 1 1 1 1 1 1 1 1 1 1 1 1 1 1 
1 1 1 1 1 1 1 1 1 0 0 1 1 1 1 3 0 0 1 1 1 1 3 1 1 1 1 1 87 1 1 1 1 1 3 3 3 3 3 1 1 1 1 1 1 1 1 1 1 1 1 1 1 1 1 1 1 1 1 1 1 1 1 1 
1 1 1 1 1 1 1 1 1 0 0 1 1 1 1 1 1 1 1 3 3 3 0 3 3 1 0 0 0 0 0 0 1 1 3 3 1 3 3 1 1 1 1 1 1 1 1 1 1 1 1 1 1 1 1 1 1 1 1 1 1 1 1 1 
20 20 20 20 20 20 20 20 20 20 0 20 20 1 1 1 1 1 8 3 3 1 3 3 3 1 0 0 0 0 0 0 1 1 0 0 0 0 0 1 1 1 1 1 1 1 1 0 1 1 1 1 1 1 1 1 1 1 1 1 1 1 1 1 
20 3 3 3 3 3 3 3 1 3 0 3 20 1 1 1 1 1 3 3 3 3 3 1 3 1 0 0 0 0 0 0 1 1 0 0 0 0 0 1 1 1 1 1 1 1 1 0 1 1 1 1 1 1 1 1 1 1 1 1 1 1 1 1 
20 3 3 3 3 1 3 3 3 3 0 3 20 1 1 1 1 1 3 3 8 1 3 1 3 1 0 0 0 0 0 0 1 1 1 0 0 0 1 1 1 20 1 1 1 1 1 0 1 1 1 1 1 1 1 1 1 1 1 1 1 1 1 1 
20 3 3 1 0 0 3 3 3 3 0 3 20 1 1 1 1 1 3 1 3 3 8 1 3 1 0 0 0 0 0 0 1 1 1 1 0 1 1 1 0 0 0 0 0 1 1 0 1 1 1 1 1 1 1 1 1 1 1 1 1 1 1 1 
20 3 3 3 0 0 3 3 3 3 0 3 1 1 1 1 1 1 3 8 3 3 3 3 3 1 0 0 0 0 0 0 1 1 1 1 0 1 1 1 0 0 0 0 0 0 0 0 1 1 1 1 1 1 1 1 1 1 1 1 1 1 1 1 
20 1 3 3 3 3 3 1 3 3 3 3 20 1 1 1 1 1 1 1 1 1 1 1 1 1 1 1 1 1 1 1 1 1 1 1 0 1 1 1 0 0 0 0 0 1 1 1 1 1 1 1 1 1 1 1 1 1 1 1 1 1 1 1 
20 3 3 3 3 3 3 3 3 1 3 3 20 1 1 1 1 1 1 0 0 3 3 3 1 8 3 1 3 3 0 0 1 1 1 1 0 1 1 1 0 0 0 0 0 1 1 1 1 1 1 1 1 1 1 1 1 1 1 1 1 1 1 1 
20 0 0 0 0 0 0 0 20 20 20 20 20 1 1 1 1 1 1 0 0 3 3 3 3 1 3 3 3 3 0 0 1 1 1 1 0 1 1 1 1 0 1 1 1 1 1 1 1 1 3 3 3 3 3 3 3 3 3 1 1 1 1 1 
1 3 3 3 3 3 3 3 1 1 1 1 1 1 1 1 1 1 1 0 0 3 1 3 1 3 1 3 3 3 0 0 1 1 1 0 0 0 1 1 1 0 1 1 1 1 1 1 1 1 3 0 0 0 0 0 0 0 3 1 1 1 1 1 
1 3 3 3 3 3 3 3 1 1 0 0 0 0 0 0 0 1 1 0 0 3 3 3 1 1 8 1 3 3 0 0 1 1 0 0 0 0 0 1 1 0 1 1 1 1 1 1 1 1 3 0 0 0 0 0 0 0 3 1 1 1 1 1 
1 0 0 0 0 0 0 0 1 1 0 0 0 0 0 0 0 1 1 0 0 3 3 3 1 3 3 1 3 3 0 0 1 1 0 0 0 0 0 1 1 0 1 1 1 1 3 3 1 1 3 0 0 0 0 0 0 0 3 1 1 1 1 1 
1 0 0 0 0 0 0 0 1 1 0 0 0 0 0 0 0 1 1 0 0 3 3 0 3 0 1 3 3 3 0 0 1 1 0 0 1 0 0 1 1 0 1 1 1 1 3 3 1 1 3 0 0 1 1 1 0 0 3 1 1 1 1 1 
1 0 0 0 0 0 0 0 1 1 0 0 0 0 0 0 0 0 0 0 0 3 1 0 3 0 1 3 3 3 0 0 0 0 0 1 1 1 0 3 3 45 3 3 0 0 0 0 1 1 3 0 0 1 1 1 0 0 3 1 1 1 1 1 
1 20 20 20 0 20 20 20 1 1 0 0 0 0 0 0 0 1 1 0 0 3 1 3 3 1 3 3 1 3 0 0 1 1 0 0 1 0 0 1 1 0 1 1 1 1 0 0 1 1 3 0 0 0 0 0 0 0 3 1 1 1 1 1 
1 1 1 1 3 1 1 1 1 1 0 0 0 0 0 0 0 1 1 0 0 3 1 3 3 0 3 3 3 3 0 0 1 1 0 0 0 0 0 1 1 0 1 1 3 3 3 3 3 1 1 1 1 3 3 3 1 1 1 1 1 1 1 1 
1 1 1 1 0 1 1 1 1 1 0 0 0 0 0 0 0 1 1 0 0 3 1 1 3 3 3 3 3 3 0 0 1 1 0 0 0 0 0 1 1 0 1 1 3 0 0 0 0 1 1 1 1 3 3 3 1 1 1 1 1 1 1 1 
1 0 0 0 0 0 0 0 1 1 1 1 1 1 1 1 1 1 1 0 0 3 1 3 0 0 1 3 3 3 0 0 1 1 1 0 0 0 1 1 1 0 1 1 3 0 0 0 0 1 1 1 0 0 0 0 0 0 1 1 1 1 1 1 
1 0 20 20 1 20 20 0 1 8 1 8 1 8 1 8 1 8 1 0 0 1 1 3 1 1 1 3 3 3 0 0 1 1 1 1 0 1 1 1 1 0 1 1 3 0 0 0 0 3 3 3 0 0 0 0 0 0 1 1 1 1 1 1 
1 0 20 8 0 0 0 0 1 3 1 3 1 3 1 3 1 3 1 0 0 3 1 3 3 3 3 3 3 3 0 0 1 1 1 1 0 1 1 1 1 0 1 1 3 0 0 0 0 3 3 3 0 0 0 0 0 0 1 1 1 1 1 1 
1 0 20 8 0 0 0 0 0 0 0 0 0 0 0 0 0 0 1 0 1 1 1 1 1 1 1 1 1 1 1 0 1 1 3 3 3 3 3 1 1 0 1 1 3 0 0 0 0 1 1 1 0 0 0 128 0 0 1 1 1 1 1 1 
1 0 20 8 0 0 8 0 0 0 0 0 0 0 0 87 0 0 1 0 0 3 3 3 3 3 3 3 3 3 0 0 1 1 3 3 3 3 3 1 1 0 1 1 3 0 0 0 0 1 1 1 1 1 1 1 1 1 1 1 1 1 1 1 
1 0 20 8 0 0 8 0 0 0 0 0 0 0 0 0 0 0 1 1 1 1 1 1 1 1 1 1 1 1 1 1 1 1 3 3 3 3 3 1 1 0 1 1 1 1 1 1 1 1 1 1 1 1 1 1 1 1 1 1 1 1 1 1 
1 0 20 8 0 0 8 0 1 3 1 3 1 3 1 1 0 0 3 3 3 3 3 3 3 3 3 3 3 3 3 3 3 3 3 3 3 3 3 1 1 0 1 1 1 1 1 1 1 1 1 1 1 1 1 1 1 1 1 1 1 1 1 1 
1 0 20 20 20 20 20 0 1 8 1 8 1 8 1 1 0 0 3 3 3 3 3 3 3 3 3 3 3 3 3 3 3 3 3 3 1 3 3 1 1 20 1 1 1 1 1 1 1 1 1 1 1 1 1 1 1 1 1 1 1 1 1 1 
1 0 0 0 0 0 0 0 1 1 1 1 1 1 1 1 0 0 3 3 3 3 3 3 3 3 3 3 3 3 3 3 1 3 3 3 3 3 3 1 1 1 1 1 1 1 1 1 1 1 1 1 1 1 1 1 1 1 1 1 1 1 1 1 
1 1 1 1 1 1 1 1 1 1 1 1 1 1 1 1 1 1 1 1 1 1 1 1 1 1 1 1 1 1 1 1 1 1 1 1 1 1 1 1 1 1 1 1 1 1 1 1 1 1 1 1 1 1 1 1 1 1 1 1 1 1 1 1 
f
p  54 57 2 0 
inventory  0 0 0 0 0 0 0 0 0 
t 0 
level 1
block 9 26 -1 0
block 11 26 -1 0
block 44 32 -1 0
block 46 32 -1 0
block 44 34 -1 0
block 46 34 -1 0
block 27 38 -1 0
block 29 38 -1 0
block 35 38 -1 0
block 37 38 -1 0
block 28 39 -1 0
block 30 39 -1 0
block 27 40 -1 0
block 29 40 -1 0
block 28 41 -1 0
block 30 41 -1 0
block 1 45 -1 0
block 2 45 -1 0
block 3 45 -1 0
block 4 45 -1 0
block 5 45 -1 0
block 6 45 -1 0
block 7 45 -1 0
block 11 48 -1 0
block 13 48 -1 0
block 15 48 -1 0
block 36 48 -1 0
block 53 48 -1 0
block 55 48 -1 0
block 2 49 -1 0
block 4 49 -1 0
block 6 49 -1 0
block 12 49 -1 0
block 14 49 -1 0
block 11 50 -1 0
block 13 50 -1 0
block 15 50 -1 0
block 12 51 -1 0
block 14 51 -1 0
block 11 52 -1 0
block 13 52 -1 0
block 15 52 -1 0
block 36 52 -1 0
block 9 58 -1 0
block 11 58 -1 0
block 13 58 -1 0
bug 3 13 0 0
bug 1 13 2 0
bug 4 58 0 0
bug 4 56 1 0
bug 6 56 1 0
bug 7 55 0 0
bug 5 54 3 0
bug 3 54 3 0
bug 1 56 2 0
bug 1 60 2 0
bug 1 62 1 0
bug 3 62 1 0
bug 5 62 1 0
bug 7 62 0 0
bug 7 60 0 0
bug 5 60 3 0
 lightbridge 7 32 1 0
 lightbridge 26 7 0 0
 lightbridge 22 7 0 0
 lightbridge 16 31 2 0
 lazer 14 31 1 0
 lazer 7 34 0 0
 lazer 29 30 2 0
 lazer 27 27 3 0
 lazer 27 25 3 0
 lazer 27 19 3 0
