18 18
1 1 1 1 1 1 1 1 1 1 1 1 1 1 1 1 1 1 
1 1 1 1 1 1 1 1 1 1 1 1 1 1 1 1 1 1 
1 1 1 1 1 1 1 1 1 1 1 1 1 1 1 1 1 1 
1 1 1 0 0 0 0 0 0 1 0 0 0 0 0 1 1 1 
1 1 1 0 0 0 0 0 128 1 0 0 0 0 0 1 1 1 
1 1 1 1 1 1 0 1 0 1 0 0 0 0 0 1 1 1 
1 1 1 0 0 0 0 1 0 1 0 1 0 0 0 0 1 1 
1 1 1 0 0 1 0 1 0 0 0 1 0 0 0 0 1 1 
1 1 1 0 0 0 0 1 1 1 1 1 3 3 3 3 1 1 
1 1 1 0 1 1 1 1 0 0 3 1 0 0 0 0 1 1 
1 1 1 0 0 0 0 1 3 1 10 1 0 1 1 1 1 1 
1 1 1 1 3 3 3 1 0 1 1 20 0 0 0 0 1 1 
1 1 1 20 0 0 0 0 0 0 1 0 0 0 20 0 20 1 
1 1 1 20 0 0 0 0 0 0 11 0 0 0 20 0 20 1 
1 1 1 20 0 0 0 0 0 0 1 0 0 0 11 0 20 1 
1 1 1 20 20 20 20 20 1 1 1 1 20 20 20 20 20 1 
1 1 1 1 1 1 1 1 1 1 1 1 1 1 1 1 1 1 
1 1 1 1 1 1 1 1 1 1 1 1 1 1 1 1 1 1 
f
p  8 3 2 0 
inventory  0 0 0 0 0 0 0 0 0 
t 0 
level 1
block 9 7 0 0
block 5 8 2 0
block 14 11 1 0
