18 18
1 1 1 1 1 1 1 1 1 1 1 1 1 1 1 1 1 1 
1 0 0 0 1 0 0 0 0 0 0 0 0 1 0 0 0 1 
1 0 17 0 1 0 0 0 0 0 0 0 0 1 0 0 0 1 
1 0 0 0 25 0 0 0 0 0 0 0 0 1 0 0 0 1 
1 0 0 0 1 0 0 0 0 0 0 0 0 1 0 0 0 1 
1 0 0 0 1 0 0 0 0 0 0 0 0 1 0 0 0 1 
1 0 0 0 1 0 0 0 0 0 0 0 0 30 0 0 0 1 
1 0 128 0 1 0 0 0 0 0 0 0 0 30 0 0 0 1 
1 0 0 0 1 0 0 0 0 0 0 0 0 1 0 0 0 1 
1 0 0 0 1 0 0 0 0 0 0 0 0 1 0 0 0 1 
1 0 0 0 1 0 0 0 0 0 0 0 0 1 0 0 0 1 
1 0 0 0 1 0 0 0 0 0 0 0 0 1 0 0 0 1 
1 0 0 0 1 0 0 0 0 0 0 0 0 1 0 0 0 1 
1 1 0 1 1 1 1 1 1 1 1 1 1 1 1 1 1 1 
1 1 0 0 0 0 0 0 0 0 0 0 0 0 0 0 0 1 
1 1 0 0 0 0 0 0 0 0 0 0 0 0 0 0 0 1 
1 1 1 1 1 1 1 1 1 1 1 1 1 1 1 1 1 1 
1 1 1 1 1 1 1 1 1 1 1 1 1 1 1 1 1 1 
f
p  1 7 0 0 
level 0
teeth 15 3 3 0
teeth 15 4 3 0
teeth 15 5 3 0
teeth 15 6 3 0
teeth 15 8 3 0
teeth 15 10 3 0
teeth 15 11 3 0
teeth 15 12 3 0
teeth 16 12 3 0
teeth 16 10 3 0
teeth 15 9 3 0
teeth 16 9 3 0
teeth 16 8 3 0
teeth 16 7 3 0
teeth 16 6 3 0
teeth 16 5 3 0
teeth 16 11 3 0
teeth 15 7 3 0
teeth 16 3 3 0
teeth 16 4 3 0
teeth 15 2 3 0
teeth 15 1 3 0
teeth 16 1 3 0
teeth 16 2 3 0
