18 22
1 1 1 1 1 1 1 1 1 1 1 1 1 1 1 1 1 1 1 1 1 1 
1 1 0 0 0 0 1 1 3 3 3 3 3 8 1 1 1 1 1 1 1 1 
1 1 0 0 0 0 3 3 3 3 3 3 3 3 3 3 3 3 0 0 1 1 
1 1 8 3 3 3 3 3 3 3 3 3 3 3 3 3 3 3 0 9 10 1 
1 1 3 3 3 3 3 3 3 8 3 3 3 3 3 3 3 3 0 0 1 1 
1 3 3 3 3 8 1 1 1 1 1 3 3 3 3 3 3 3 1 1 1 1 
1 3 3 3 1 1 1 1 1 1 1 3 3 3 3 3 0 1 1 1 1 1 
1 3 3 3 1 1 1 3 3 3 0 3 3 3 0 0 0 20 1 1 1 1 
1 3 3 8 1 1 8 0 3 3 3 3 3 0 0 0 0 1 1 1 1 1 
1 3 3 3 1 1 8 0 3 3 3 3 3 0 0 0 0 1 1 1 1 1 
1 3 3 3 1 1 1 3 3 3 3 3 3 0 0 0 0 1 1 1 1 1 
1 3 3 3 3 1 1 1 3 3 0 3 3 3 0 0 0 20 1 1 1 1 
1 3 3 3 3 3 8 1 1 1 1 1 3 3 3 0 0 1 1 1 1 1 
1 3 3 3 3 3 3 3 3 3 3 3 3 3 3 3 3 1 1 1 1 1 
1 0 0 0 3 3 3 3 3 3 3 3 3 3 3 3 3 3 0 0 1 1 
1 0 0 0 0 8 0 128 3 3 3 3 3 3 3 3 3 3 0 0 1 1 
1 1 1 1 1 1 1 3 3 3 3 3 3 3 3 3 3 0 0 20 1 1 
1 1 1 1 1 1 1 1 1 1 1 1 1 1 1 1 1 1 1 1 1 1 
f
p  19 15 3 0 
inventory  0 0 0 0 0 0 0 0 0 
t 0 
level 1
reflector 10 7 2 1
reflector 10 11 3 0
block 2 14 2 0
block 3 2 1 0
 lightbridge 19 16 3 0
 lazer 17 11 3 0
 lazer 17 7 3 0
