32 40
1 1 1 1 1 1 1 1 1 1 1 1 1 1 1 1 1 1 1 1 1 1 1 1 1 1 1 1 1 1 1 1 1 1 1 1 1 1 1 1 
1 1 1 1 1 1 1 1 1 1 1 1 1 1 0 0 0 0 0 0 0 1 1 1 1 1 1 1 1 1 1 1 1 1 1 1 1 1 1 1 
1 1 1 1 1 1 1 1 1 1 1 1 1 1 0 0 0 0 0 0 0 1 1 1 1 1 1 1 1 1 1 1 1 1 1 1 1 1 1 1 
1 1 1 1 1 1 1 1 1 1 1 1 1 1 0 0 0 0 0 0 0 1 1 1 1 1 1 1 1 1 1 1 1 1 1 1 1 1 1 1 
1 1 1 1 1 1 1 1 1 1 1 1 1 1 1 1 1 1 1 1 0 1 1 1 1 1 1 1 1 1 1 1 1 1 1 1 1 1 1 1 
1 1 1 1 1 1 1 1 1 1 1 1 1 1 1 1 1 1 1 1 0 1 1 1 1 13 1 1 1 1 1 1 1 1 1 1 1 1 1 1 
1 1 1 1 1 1 1 1 1 1 1 39 39 39 0 0 0 0 0 0 0 0 0 1 1 0 1 1 1 1 1 1 1 1 1 1 1 1 1 1 
1 1 1 1 1 1 1 1 1 1 1 39 39 0 0 0 0 0 0 0 0 0 0 0 0 0 39 39 1 1 1 1 1 1 1 1 1 1 1 1 
1 1 13 7 1 1 1 1 1 1 1 39 0 0 1 1 30 30 30 30 30 30 1 1 0 0 0 39 0 1 1 1 1 1 1 1 1 1 1 1 
1 1 1 1 1 1 1 1 1 1 1 0 0 0 1 0 0 0 0 0 0 0 0 1 0 0 0 0 1 1 1 1 1 1 1 1 1 1 1 1 
1 1 13 7 1 1 1 1 1 1 1 0 0 0 30 0 0 0 0 0 0 0 0 30 0 0 0 0 1 1 1 1 1 1 1 1 1 1 1 1 
1 1 1 1 1 1 1 1 1 1 0 0 0 0 30 0 0 0 0 0 0 0 0 30 0 0 128 0 0 13 1 1 1 1 1 1 1 1 1 1 
1 1 13 7 1 1 1 1 1 1 1 0 0 0 30 0 0 0 8 0 0 0 0 30 0 0 0 0 1 1 1 1 1 1 1 1 1 1 1 1 
1 10 9 1 1 1 1 1 1 1 1 0 0 0 30 0 0 0 0 0 0 0 0 30 0 0 0 0 0 13 1 1 1 1 1 1 1 1 1 1 
1 1 13 7 1 1 1 1 1 1 1 0 0 0 30 0 0 0 0 0 0 0 0 30 0 0 0 0 1 1 1 1 1 1 1 1 1 1 1 1 
1 1 1 1 1 1 1 1 1 1 1 0 0 0 30 0 0 0 0 0 0 0 0 30 0 0 0 0 1 1 1 1 1 24 1 1 1 1 1 1 
1 1 13 7 1 1 1 1 1 1 1 0 0 0 1 0 0 0 0 0 0 0 0 1 0 0 0 39 1 1 1 39 39 39 1 1 1 1 1 1 
1 1 1 1 1 1 1 1 1 1 1 0 0 0 1 1 30 30 30 30 30 30 1 1 0 0 39 39 1 1 1 39 39 39 1 1 1 1 1 1 
1 1 13 7 1 1 1 1 1 1 1 39 0 0 0 0 0 0 0 0 0 0 0 0 0 0 1 1 1 1 1 1 0 0 1 1 1 1 1 1 
1 1 1 1 1 1 1 1 1 1 1 39 39 0 0 0 0 0 0 0 17 0 0 0 0 0 45 45 45 45 45 45 45 45 1 1 1 1 1 1 
1 1 1 1 1 1 1 1 1 1 1 39 39 39 0 0 0 0 0 0 0 0 0 0 0 0 45 45 45 45 45 45 45 45 1 1 1 1 1 1 
1 1 1 1 1 1 1 1 1 1 1 1 1 1 1 1 1 1 1 1 1 1 1 1 1 1 1 1 1 45 45 1 1 1 1 1 1 1 1 1 
1 1 1 1 1 1 1 1 1 1 1 1 1 1 1 1 1 1 1 1 1 1 1 1 1 1 1 1 1 45 45 1 1 1 1 1 1 1 1 1 
1 1 1 1 1 1 1 1 1 1 1 1 1 1 1 1 1 1 1 1 1 1 1 1 1 1 1 1 1 45 48 1 1 1 1 1 1 1 1 1 
1 1 1 1 1 1 1 1 1 1 1 1 1 1 1 1 1 1 1 1 1 1 0 7 7 7 7 7 7 45 45 1 1 1 1 1 1 1 1 1 
1 1 1 1 1 1 1 1 1 1 1 1 1 1 1 1 1 1 1 1 1 1 7 7 7 7 7 7 7 45 45 1 1 1 1 1 1 1 1 1 
1 1 1 1 1 1 1 1 1 1 1 1 1 1 1 1 1 1 1 1 1 1 7 7 7 7 7 1 1 45 45 1 1 1 1 1 1 1 1 1 
1 1 1 1 1 1 1 1 1 1 1 1 1 1 1 1 1 1 1 1 1 1 7 7 7 7 7 1 1 1 1 1 1 1 1 1 1 1 1 1 
1 1 1 1 1 1 1 1 1 1 1 1 1 1 1 1 1 1 1 1 1 1 7 7 7 7 7 1 1 1 1 1 1 1 1 1 1 1 1 1 
1 1 1 1 1 1 1 1 1 1 1 1 1 1 1 1 1 1 1 1 1 1 1 1 1 1 1 1 1 1 1 1 1 1 1 1 1 1 1 1 
1 1 1 1 1 1 1 1 1 1 1 1 1 1 1 1 1 1 1 1 1 1 1 1 1 1 1 1 1 1 1 1 1 1 1 1 1 1 1 1 
1 1 1 1 1 1 1 1 1 1 1 1 1 1 1 1 1 1 1 1 1 1 1 1 1 1 1 1 1 1 1 1 1 1 1 1 1 1 1 1 
f
p  25 11 2 0 
inventory  0 0 0 0 0 0 0 0 0 
t 0 
level 1
ball 16 13 0 0 
ball 17 13 3 0 
ball 18 13 2 0 
glider 19 15 0 0
glider 19 10 0 0
glider 22 13 3 0
glider 21 14 0 0
glider 17 11 2 0
blob 21 12 3 0
blob 20 12 3 0
blob 19 12 0 0
teeth 15 11 2 0
teeth 18 9 2 0
teeth 21 11 0 0
fireball 19 16 3 0
fireball 18 16 3 0
fireball 17 16 3 0
fireball 17 15 3 0
fireball 16 15 1 0
param 21 16 3 0
param 20 16 1 0
param 19 13 2 0
bug 17 12 0 0
bug 16 10 1 0
bug 18 11 1 0
bug 19 11 1 0
tank 15 14 3 0
tank 20 13 0 0
tank 16 11 1 0
walker 22 16 0 0
walker 15 16 0 0
walker 18 10 3 0
block 16 19 3 0
block 18 19 1 0
block 12 9 3 0
block 12 15 0 0
block 12 16 2 0
block 15 2 1 0
block 17 2 2 0
block 16 2 3 0
block 15 3 2 0
block 18 2 1 0
