18 27
1 1 1 1 1 1 1 1 1 1 1 1 1 1 1 1 1 1 1 1 1 1 1 1 1 1 1 
1 1 1 1 1 1 1 1 1 1 1 1 1 1 1 1 1 1 1 1 1 1 1 1 1 1 1 
1 1 0 0 0 0 0 0 0 0 0 0 0 1 3 3 3 1 1 0 0 0 0 0 1 1 1 
1 1 0 0 0 0 0 0 0 0 0 0 0 1 3 3 3 1 0 0 0 0 0 0 0 1 1 
1 1 0 0 0 0 0 0 0 0 0 0 0 0 3 3 3 0 0 0 0 0 0 0 0 1 1 
1 1 0 0 0 0 1 0 0 0 0 0 0 0 3 3 3 0 0 0 0 0 0 0 0 1 1 
1 1 0 0 0 0 3 0 0 0 0 0 0 0 3 3 0 0 0 0 0 0 0 0 0 1 1 
1 1 0 0 0 0 3 1 0 0 0 0 0 0 3 3 0 0 0 0 0 0 0 0 0 1 1 
1 1 0 0 0 0 3 3 0 0 0 0 0 0 3 3 0 0 0 0 0 1 0 0 0 1 1 
1 1 0 0 0 0 3 3 0 0 0 0 0 0 0 3 0 0 0 0 3 3 3 0 0 1 1 
1 1 0 0 0 0 3 3 0 0 0 0 0 0 0 3 0 0 0 0 3 3 3 0 0 1 1 
1 1 0 0 0 0 3 3 1 0 0 0 0 0 0 0 0 0 0 0 3 3 3 0 0 1 1 
1 1 1 1 1 0 3 3 3 0 0 0 0 0 0 0 0 0 0 3 3 3 3 0 0 1 1 
1 1 1 1 1 0 3 3 3 0 0 0 0 0 0 0 0 1 3 3 3 3 0 0 0 1 1 
1 1 0 0 0 0 3 3 3 0 0 0 0 0 0 0 0 3 3 10 0 0 0 0 0 1 1 
1 1 45 45 45 45 45 45 45 45 45 45 45 45 45 45 45 45 45 45 45 45 45 45 45 1 1 
1 1 1 1 1 1 1 1 1 1 1 1 1 1 1 1 1 1 1 1 1 1 1 1 1 1 1 
1 1 1 1 1 1 1 1 1 1 1 1 1 1 1 1 1 1 1 1 1 1 1 1 1 1 1 
f
p  3 11 0 0 
inventory  0 0 0 0 0 0 0 0 0 
t 0 
level 1
reflector 10 15 1 3
reflector 2 14 2 1
reflector 12 2 1 2
reflector 18 3 1 1
reflector 19 2 2 1
reflector 24 3 1 2
reflector 23 2 2 2
reflector 22 6 3 2
reflector 10 8 1 2
reflector 11 13 0 1
reflector 14 11 3 1
reflector 2 2 2 1
 lazer 1 15 1 0
