32 32
1 1 1 1 1 1 1 1 1 1 1 1 1 1 1 1 1 1 1 1 1 1 1 1 1 1 1 1 1 1 1 1 
1 1 1 14 14 14 14 14 14 14 14 14 14 14 14 1 1 1 1 1 1 1 1 1 1 1 1 10 1 1 1 1 
1 1 1 14 0 0 0 0 0 0 0 0 0 0 14 1 1 1 1 1 1 1 1 1 1 1 1 0 1 1 1 1 
1 1 1 14 0 8 14 14 14 14 14 14 14 14 14 1 1 1 1 1 1 1 1 1 1 1 0 201 0 0 0 1 
1 0 0 14 0 0 0 0 0 0 0 0 0 0 14 0 9 0 0 0 0 0 0 0 0 0 0 0 0 0 0 1 
1 0 1 14 14 14 14 14 14 14 14 14 8 0 14 1 1 1 1 1 1 1 1 1 1 1 0 0 18 0 0 1 
1 0 1 14 0 0 0 0 0 0 0 0 0 0 14 45 47 1 1 46 45 45 45 47 1 1 0 0 0 0 0 1 
1 0 1 14 14 14 14 14 14 14 14 14 14 14 14 1 45 1 1 45 1 1 1 45 1 1 0 0 0 0 0 1 
1 0 1 1 1 1 1 0 1 1 1 1 1 1 1 1 45 1 1 45 1 27 1 45 1 1 1 1 1 1 1 1 
1 0 1 1 1 1 1 0 1 1 1 1 1 1 1 1 49 45 45 48 1 0 1 49 45 45 45 45 45 47 1 1 
1 0 1 1 1 1 1 0 1 1 8 1 1 1 1 1 1 1 1 1 1 0 1 1 1 1 1 1 1 45 1 1 
1 0 1 1 1 0 0 0 1 0 0 0 1 1 1 0 0 0 0 0 0 0 0 0 0 0 0 0 1 45 1 1 
1 0 1 1 1 0 1 1 1 0 1 0 1 1 1 0 1 1 1 1 1 0 1 1 1 1 1 0 1 45 1 1 
1 0 1 1 1 0 0 0 0 0 0 0 1 1 1 0 1 28 32 25 0 0 0 25 34 26 1 0 1 45 1 1 
1 0 1 0 0 0 0 0 0 0 0 0 1 0 1 0 1 1 1 1 1 0 1 1 1 1 1 0 1 45 1 1 
1 0 1 0 1 0 1 1 1 1 1 1 1 0 1 0 1 29 33 30 0 0 0 30 31 45 45 45 45 48 1 1 
1 0 1 0 0 0 39 39 39 39 0 39 39 8 1 0 1 1 1 1 1 0 1 1 1 1 1 0 1 1 1 1 
1 0 1 1 1 1 1 1 1 1 0 0 8 8 1 0 0 0 0 0 0 0 0 0 0 0 0 0 1 1 1 1 
1 0 0 0 0 0 1 1 8 0 0 39 39 0 1 1 1 1 1 1 1 0 1 1 1 1 1 1 1 1 1 1 
1 0 6 6 6 0 1 1 1 1 1 1 1 1 1 1 26 1 1 1 1 17 1 1 1 1 1 1 1 1 1 1 
1 0 6 8 6 0 1 1 1 1 1 1 1 1 1 1 3 1 1 1 1 43 1 1 1 1 1 1 1 1 1 1 
1 0 6 19 6 0 1 1 1 1 1 1 1 1 1 1 3 1 1 1 1 0 1 1 1 1 1 1 1 1 1 1 
1 0 0 0 0 0 1 0 41 1 1 1 1 1 1 1 3 1 1 1 7 45 7 7 7 7 7 7 7 7 7 1 
1 1 1 1 1 1 1 0 41 41 1 1 1 1 1 1 3 1 0 31 45 45 45 45 45 45 45 45 0 45 7 1 
1 0 0 0 0 8 33 0 41 41 41 1 0 0 0 0 0 0 0 1 7 45 45 0 45 45 45 0 45 45 7 1 
1 1 1 0 1 1 1 0 41 41 41 6 0 0 0 0 0 1 1 1 7 45 0 45 0 45 45 45 45 45 7 1 
1 0 0 0 0 0 1 0 41 41 41 6 0 0 0 0 0 1 1 1 7 45 45 0 45 45 8 45 45 0 7 1 
1 0 0 0 0 0 1 0 41 41 41 19 0 0 0 0 0 1 1 1 7 0 45 45 45 0 45 45 45 45 7 1 
1 0 0 28 0 0 1 43 42 42 42 6 0 0 0 0 0 1 1 1 7 45 0 45 45 45 45 0 45 45 7 1 
1 0 0 128 0 0 1 1 1 1 1 1 1 1 1 1 1 1 1 1 7 45 45 45 0 45 45 45 0 45 7 1 
1 0 0 0 0 0 1 1 1 1 1 1 1 1 1 1 1 1 1 1 7 45 45 45 45 0 45 45 45 0 7 1 
1 1 1 1 1 1 1 1 1 1 1 1 1 1 1 1 1 1 1 1 7 7 7 7 7 7 7 7 7 7 7 1 
f
p  1 24 -1 0 
inventory  0 0 0 0 0 0 0 0 0 
p  19 4 1 0 
inventory  0 0 0 0 0 0 0 0 0 
t 0 
level 1
block 28 6 -1 0
block 7 13 -1 0
block 9 13 -1 0
block 6 14 -1 0
block 8 14 -1 0
block 13 16 -1 0
block 15 25 -1 0
block 14 26 -1 0
block 13 27 -1 0
block 15 27 -1 0
fireball 4 26 3 0
fireball 2 30 1 0
fireball 27 14 0 0
fireball 21 17 1 0
fireball 15 14 2 0
fireball 21 11 3 0
fireball 29 4 0 0
bug 12 2 0 0
bug 9 2 0 0
bug 6 2 0 0
bug 4 3 0 0
bug 6 4 0 0
bug 9 4 0 0
bug 12 4 0 0
bug 13 5 0 0
bug 11 6 0 0
bug 8 6 0 0
bug 5 6 0 0
trap 28 5 1 27 3 -1
