29 23
1 1 1 1 1 1 1 1 1 1 1 1 1 1 1 1 1 1 1 1 1 1 1 
1 1 1 1 1 1 1 1 1 1 1 1 1 1 1 1 1 1 1 1 1 1 1 
1 1 1 1 1 1 1 1 1 1 1 1 1 1 1 1 1 1 1 1 1 1 1 
1 1 1 1 1 1 1 1 1 1 1 1 1 1 1 1 1 1 1 1 1 1 1 
1 1 1 1 1 1 8 0 0 0 0 0 1 1 1 1 1 1 1 1 1 1 1 
1 1 1 1 1 1 0 0 0 0 0 0 1 1 1 1 1 1 1 1 1 1 1 
1 1 1 1 1 1 0 0 0 0 0 0 1 1 1 1 1 1 1 1 1 1 1 
1 1 1 1 1 42 42 42 42 42 42 42 1 1 1 1 1 1 1 1 1 1 1 
1 1 1 1 1 1 0 0 0 0 0 0 1 1 1 1 1 1 1 1 1 1 1 
1 1 1 1 1 1 0 0 0 0 0 0 1 1 1 1 1 1 1 1 1 1 1 
1 1 1 1 1 1 0 0 0 0 0 0 1 1 1 1 1 1 1 1 1 1 1 
1 1 1 1 1 0 0 0 0 0 0 0 1 1 1 1 1 1 1 1 1 1 1 
1 1 1 1 1 0 0 0 128 0 0 0 1 1 1 1 1 1 1 1 1 1 1 
1 1 1 1 1 1 1 0 0 1 1 1 1 1 1 1 1 1 1 1 1 1 1 
1 1 1 1 1 1 1 1 0 0 1 1 1 1 1 1 1 1 1 1 1 1 1 
1 1 1 1 1 1 1 1 1 0 1 1 1 1 1 1 1 1 1 1 1 1 1 
1 1 1 1 1 1 1 1 0 0 0 0 0 0 0 1 1 1 1 0 1 1 1 
1 1 1 3 1 1 0 1 8 0 0 0 0 0 0 1 1 1 1 0 1 1 1 
1 1 1 3 1 1 0 0 8 8 0 0 0 0 8 1 1 1 1 0 1 1 1 
1 1 1 3 0 0 0 1 8 0 8 0 0 8 8 8 8 8 8 8 1 1 1 
1 1 1 1 1 1 1 1 0 8 8 0 0 0 8 1 1 1 1 0 1 1 1 
1 1 1 1 1 1 1 1 8 0 0 0 0 0 0 1 1 1 1 0 1 1 1 
1 1 1 1 1 1 1 8 8 8 0 0 0 0 0 1 1 1 1 0 1 1 1 
1 1 1 1 1 1 1 1 1 0 0 0 0 0 0 1 1 1 1 1 1 1 1 
1 1 1 1 1 1 1 1 1 1 0 1 0 1 1 1 1 1 1 1 1 1 1 
1 1 1 1 1 1 1 1 1 1 0 0 0 0 1 1 1 1 1 1 1 1 1 
1 1 1 1 1 1 1 1 1 1 1 0 221 0 1 1 1 1 1 1 1 1 1 
1 1 1 1 1 1 1 1 1 1 1 0 0 0 1 1 1 1 1 1 1 1 1 
1 1 1 1 1 1 1 1 1 1 1 1 1 1 1 1 1 1 1 1 1 1 1 
f
p  5 12 2 0 
inventory  0 0 0 0 0 0 0 0 0 
t 0 
level 1
block 6 4 1 0
block 10 23 2 0
block 9 22 1 0
block 8 21 0 0
block 10 21 3 0
block 11 22 2 0
block 12 23 2 0
block 13 22 2 0
block 12 21 3 0
block 15 19 1 0
block 16 19 1 0
block 17 19 1 0
block 18 19 1 0
block 19 19 3 0
block 14 20 0 0
block 14 19 0 0
block 14 18 2 0
block 13 19 2 0
block 14 21 2 0
block 13 20 3 0
block 12 19 0 0
block 13 18 3 0
block 14 17 2 0
block 14 16 1 0
block 13 17 1 0
block 13 16 1 0
block 12 17 2 0
block 12 18 3 0
block 12 20 1 0
block 13 21 2 0
block 14 22 2 0
block 8 22 1 0
block 7 22 3 0
block 9 16 2 0
block 9 18 0 0
block 10 17 0 0
block 7 17 1 0
block 8 17 2 0
block 8 18 2 0
block 8 19 3 0
block 10 19 0 0
block 11 18 3 0
block 11 16 2 0
block 11 20 1 0
block 9 20 1 0
block 10 20 3 0
block 9 17 3 0
block 19 20 2 0
block 19 21 2 0
block 19 22 3 0
block 19 18 0 0
block 19 17 0 0
block 19 16 3 0
 excursionfunnel 5 8 1 1
