18 21
1 1 1 1 1 1 1 1 1 1 1 1 1 1 1 1 1 1 1 1 1 
1 20 20 20 20 20 20 20 20 20 20 20 20 20 20 20 20 1 1 1 1 
1 20 45 45 45 45 45 11 8 8 11 45 45 45 45 45 20 1 1 1 1 
1 20 45 45 45 45 45 45 47 46 45 45 45 45 45 45 20 1 1 1 1 
1 20 45 45 8 11 45 45 45 45 45 45 11 8 45 45 20 1 1 1 1 
1 20 45 45 11 8 45 45 11 11 45 45 8 11 45 45 20 1 1 1 1 
1 20 45 45 45 45 45 45 45 45 45 45 45 45 45 45 20 20 20 1 1 
1 20 11 45 45 45 45 1 45 45 1 45 45 45 45 1 0 0 20 1 1 
1 20 8 11 45 45 45 45 11 11 45 45 45 45 11 8 0 0 20 1 1 
1 20 8 11 45 45 45 45 11 11 45 45 45 45 11 8 0 128 20 1 1 
1 20 11 45 45 45 45 1 45 45 1 45 45 45 45 1 0 0 20 1 1 
1 20 45 45 45 45 45 45 45 45 45 45 45 45 45 45 20 20 20 1 1 
1 20 45 45 11 8 45 45 11 11 45 45 8 11 45 45 20 1 1 1 1 
1 20 45 45 8 11 45 45 45 45 45 45 11 8 45 45 20 1 1 1 1 
1 20 45 45 45 45 45 45 48 49 45 45 45 45 45 45 0 0 9 10 1 
1 20 45 45 45 45 45 11 8 8 11 45 45 45 45 45 20 1 1 1 1 
1 20 20 20 20 20 20 20 20 20 20 20 20 20 20 20 20 1 1 1 1 
1 1 1 1 1 1 1 1 1 1 1 1 1 1 1 1 1 1 1 1 1 
f
p  17 8 3 0 
inventory  0 0 0 0 0 0 0 0 0 
t 0 
level 1
