18 18
20 20 20 20 20 20 20 20 20 20 20 20 20 20 20 20 20 20 
20 3 3 3 3 3 3 3 3 3 3 3 3 3 3 3 3 20 
20 3 3 0 0 0 3 3 3 3 3 3 0 0 0 3 3 20 
20 3 30 0 17 0 3 3 3 3 3 3 0 221 0 3 3 20 
20 3 3 0 0 0 3 3 3 3 3 3 0 0 0 3 3 20 
20 3 3 3 3 3 3 3 3 3 3 3 3 3 3 3 3 20 
20 0 0 0 0 0 0 0 0 0 0 0 0 0 0 0 0 20 
1 0 0 0 0 0 0 0 0 0 0 0 0 0 0 0 0 1 
1 0 128 0 0 0 0 0 0 0 0 0 0 0 0 0 0 1 
1 0 0 0 0 0 0 0 0 0 0 0 0 0 0 0 0 1 
1 0 0 0 0 0 0 0 0 0 0 0 0 0 0 0 0 1 
1 0 0 0 1 1 1 1 1 1 1 1 1 1 1 1 20 1 
1 0 0 0 0 0 0 0 0 0 0 0 0 0 0 0 0 1 
1 7 0 0 0 0 0 0 0 0 0 0 0 0 0 0 0 1 
20 20 20 20 15 20 0 0 1 20 3 3 3 3 3 3 3 20 
1 1 1 20 20 20 20 20 20 20 0 0 0 0 0 0 30 20 
1 1 1 1 1 1 1 1 1 20 10 0 0 0 0 0 0 20 
1 1 1 1 1 1 1 1 1 20 20 20 20 20 20 20 20 20 
f
p  3 8 3 0 
inventory  0 0 0 0 0 0 0 0 0 
t 0 
level 1
reflector 6 7 1 1
reflector 13 7 1 2
reflector 13 10 0 3
glider 5 14 1 0
spawner 4 14 1 5 14 -1
 excursionfunnel 16 17 0 1
 excursionfunnel 0 3 1 1
 lazer 0 6 1 0
 lazer 4 11 3 0
 lazer 6 11 0 0
