27 28
1 1 1 1 1 1 1 1 1 1 1 1 1 1 1 1 1 1 1 1 1 1 1 1 1 1 1 1 
1 1 1 1 1 1 1 1 1 1 1 1 1 1 1 1 1 1 1 1 1 1 1 1 1 1 1 1 
1 1 1 1 1 1 1 1 1 1 1 1 1 1 1 1 1 1 1 1 1 1 1 1 1 1 1 1 
1 1 1 1 1 1 1 1 1 1 1 1 1 1 1 1 1 1 1 1 1 1 1 1 1 1 1 1 
1 1 1 1 1 1 1 1 1 1 1 1 1 1 1 1 1 1 1 1 1 0 1 1 1 1 1 1 
1 1 1 1 1 1 1 1 1 1 1 1 1 1 1 1 1 1 1 1 0 30 0 1 1 1 1 1 
1 1 1 1 1 1 1 1 1 1 1 1 1 1 1 1 1 1 1 0 0 0 0 0 1 1 1 1 
1 1 1 1 1 1 1 1 3 0 0 0 0 1 1 1 1 1 0 0 0 0 0 0 0 1 1 1 
1 1 1 1 1 1 1 3 3 0 0 0 0 0 0 0 1 0 0 0 17 0 17 0 0 0 1 1 
1 1 1 1 1 1 3 3 3 0 0 0 0 0 0 0 0 0 0 0 0 128 0 0 0 0 0 1 
1 1 1 1 1 3 3 3 3 0 0 0 0 0 0 0 1 0 0 0 17 0 17 0 0 0 1 1 
1 1 1 1 0 3 3 3 3 0 0 0 0 1 1 1 1 1 0 0 0 0 0 0 0 1 1 1 
1 1 1 0 0 3 3 3 3 0 0 0 1 1 1 1 1 1 1 0 0 0 0 0 1 1 1 1 
1 1 1 0 0 3 3 3 3 0 0 1 1 1 1 1 1 1 1 1 0 0 0 1 1 1 1 1 
1 1 1 0 0 3 3 3 3 0 1 1 1 1 1 1 1 1 1 1 1 0 1 1 1 1 1 1 
1 1 1 0 0 3 3 3 3 1 1 1 1 1 1 1 1 1 1 1 1 1 1 1 1 1 1 1 
1 1 1 0 0 3 3 3 3 1 1 1 1 1 1 1 1 1 1 1 1 1 1 1 1 1 1 1 
1 1 1 0 0 3 3 3 3 0 1 1 1 1 1 1 1 1 1 1 1 1 1 1 1 1 1 1 
1 1 1 0 0 3 3 3 3 0 0 1 1 1 1 1 1 1 1 1 1 1 1 1 1 1 1 1 
1 1 1 0 0 3 3 3 3 0 0 0 1 1 1 1 1 1 1 1 1 1 1 1 1 1 1 1 
1 1 1 0 0 3 3 3 3 0 0 0 0 1 1 1 1 1 1 1 1 1 1 1 1 1 1 1 
1 1 1 1 0 3 3 3 3 0 0 0 0 0 0 0 0 3 1 1 1 1 1 1 10 1 1 1 
1 1 1 1 1 3 3 3 3 0 0 0 0 0 0 0 0 3 3 1 1 1 1 1 0 1 1 1 
1 1 1 1 1 1 3 3 3 0 0 0 0 0 0 0 0 3 3 3 0 0 0 0 0 0 1 1 
1 1 1 1 1 1 1 3 3 0 0 0 0 0 0 0 0 3 3 3 0 0 0 0 0 0 1 1 
1 1 1 1 1 1 1 1 3 0 0 0 0 0 0 0 0 3 3 3 0 0 0 0 0 0 1 1 
1 1 1 1 1 1 1 1 1 1 1 1 1 1 1 1 1 1 1 1 1 1 1 1 1 1 1 1 
f
p  26 9 2 0 
inventory  0 0 0 0 0 0 0 0 0 
t 0 
level 1
ball 13 8 2 0 
ball 13 9 2 0 
block 12 22 3 0
block 14 22 1 0
block 14 24 1 0
block 12 24 2 0
ball 24 22 3 0 
 lazer 21 3 2 0
