18 18
1 1 1 1 1 1 1 1 1 1 1 1 1 1 1 1 1 1 
1 1 1 1 1 1 1 1 0 0 0 0 1 10 1 1 1 1 
1 1 1 1 1 1 1 1 0 0 0 0 1 0 1 1 1 1 
1 1 1 1 0 3 3 3 0 0 0 0 3 0 0 0 1 1 
1 1 1 0 0 3 3 3 0 0 1 0 3 0 0 0 1 1 
1 1 0 0 0 3 3 3 0 0 0 0 3 0 0 0 1 1 
1 0 0 0 0 3 3 3 1 1 1 1 1 1 1 1 1 1 
1 0 0 0 0 3 3 3 1 1 1 1 1 1 1 1 1 1 
1 0 0 0 0 3 3 3 1 1 1 1 1 0 1 1 1 1 
1 0 0 0 0 3 3 3 1 1 1 1 1 30 1 1 1 1 
1 0 0 0 0 3 3 3 1 1 1 1 0 0 0 1 1 1 
1 0 0 0 0 3 3 3 1 1 1 0 17 0 17 0 1 1 
1 0 0 0 0 3 3 3 0 0 0 0 0 128 0 0 0 1 
1 1 0 0 0 3 3 3 1 1 1 0 17 0 17 0 1 1 
1 1 1 0 0 3 3 3 1 1 1 1 0 0 0 1 1 1 
1 1 1 1 0 3 3 3 1 1 1 1 1 0 1 1 1 1 
1 1 1 1 1 1 1 1 1 1 1 1 1 1 1 1 1 1 
1 1 1 1 1 1 1 1 1 1 1 1 1 1 1 1 1 1 
f
p  16 12 2 0 
inventory  0 0 0 0 0 0 0 0 0 
t 0 
level 1
ball 9 12 2 0 
ball 13 2 1 0 
block 9 2 1 0
block 10 3 1 0
block 9 4 2 0
 lazer 13 7 2 0
