18 18
1 1 1 1 1 1 1 1 1 1 1 1 1 1 1 1 1 1 
1 1 1 1 1 1 1 1 10 1 1 1 1 1 1 1 1 1 
1 1 1 1 1 1 1 1 25 1 1 1 1 1 1 1 1 1 
1 1 1 1 1 1 1 1 30 1 1 1 1 1 1 1 1 1 
1 1 3 3 3 3 3 3 25 3 3 3 3 3 3 1 1 1 
1 1 3 0 0 0 0 0 0 0 0 0 0 0 3 1 1 1 
1 1 3 0 0 0 0 0 0 0 17 0 0 0 3 1 1 1 
1 1 3 0 0 1 1 0 0 0 1 1 17 0 3 1 1 1 
1 1 3 0 0 1 1 0 0 17 1 1 0 0 3 1 1 1 
1 1 3 0 0 0 0 0 0 0 0 17 0 0 3 1 1 1 
1 1 3 0 0 0 0 0 0 0 0 0 0 0 3 1 1 1 
1 1 3 3 3 3 3 0 128 0 3 3 3 3 3 1 1 1 
1 1 1 1 1 1 3 0 0 0 3 1 1 1 1 1 1 1 
1 1 1 1 1 1 3 0 0 0 3 1 1 1 1 1 1 1 
1 1 1 1 1 1 3 3 3 3 3 1 1 1 1 1 1 1 
1 1 1 1 1 1 1 1 1 1 1 1 1 1 1 1 1 1 
1 1 1 1 1 1 1 1 1 1 1 1 1 1 1 1 1 1 
1 1 1 1 1 1 1 1 1 1 1 1 1 1 1 1 1 1 
f
p  8 12 2 0 
inventory  0 0 0 0 0 0 0 0 0 
t 0 
level 1
bug 4 7 2 0
bug 7 8 0 0
bug 6 6 3 0
bug 5 9 1 0
