18 18
1 1 1 1 1 1 1 1 1 1 1 1 1 1 1 1 1 1 
1 0 0 0 0 0 0 0 0 0 0 0 0 0 42 42 42 1 
1 1 0 0 0 0 1 1 1 1 1 1 1 31 1 1 43 1 
1 1 1 0 0 0 31 128 1 1 1 1 1 0 1 212 43 1 
1 1 1 0 0 0 1 1 1 1 1 1 1 0 45 45 0 1 
1 1 1 0 0 0 1 1 1 1 1 1 1 0 45 45 0 1 
1 1 1 0 0 0 33 9 10 1 8 8 0 0 45 45 0 1 
1 1 1 0 0 0 1 1 1 1 8 8 26 0 45 45 0 1 
1 1 1 0 0 0 1 1 1 1 1 1 1 0 45 45 0 1 
1 1 1 0 0 1 1 1 0 0 0 1 1 0 45 45 1 1 
1 1 1 45 1 1 1 1 0 0 0 1 1 1 45 45 1 1 
1 1 1 45 1 1 1 1 1 31 1 1 1 1 1 45 1 1 
1 1 1 45 1 1 1 1 0 0 0 1 1 1 1 45 1 1 
1 1 46 45 45 45 45 45 0 0 0 45 45 47 45 45 1 1 
1 1 45 49 45 45 45 45 0 0 0 45 45 45 45 48 1 1 
1 0 0 0 1 1 1 1 0 0 0 1 1 0 1 1 1 1 
1 0 0 0 3 28 1 1 1 1 1 1 8 26 8 1 1 1 
1 1 1 1 1 1 1 1 1 1 1 1 1 1 1 1 1 1 
f
p  15 3 2 0 
inventory  0 0 0 0 0 0 0 0 0 
t 0 
level 1
block 9 9 3 0
