18 26
1 1 1 1 1 1 1 1 1 1 1 1 1 1 1 1 1 1 1 1 1 1 1 1 1 1 
1 1 1 1 1 1 1 1 1 1 1 1 1 1 1 1 1 1 1 1 1 1 1 1 1 1 
1 1 1 1 1 1 1 1 1 1 1 1 1 1 1 1 1 1 1 1 1 1 1 1 1 1 
1 1 1 1 1 1 1 1 1 1 1 1 1 1 1 1 1 1 1 1 1 1 1 1 1 1 
1 1 1 1 1 1 1 1 1 1 1 1 1 1 1 1 1 1 1 1 1 1 1 1 1 1 
1 1 1 1 1 0 0 0 0 0 0 0 0 22 1 1 1 1 1 1 1 1 1 1 1 1 
1 1 1 1 1 0 0 0 30 0 17 0 128 0 1 1 1 1 1 1 1 1 1 1 1 1 
1 1 1 1 1 0 0 0 0 0 221 0 0 0 1 1 45 45 45 45 45 45 45 45 1 1 
1 1 1 1 1 0 0 0 0 0 0 0 0 0 0 0 45 45 45 45 45 45 45 45 1 1 
1 1 1 1 1 0 0 0 0 0 0 0 0 0 1 1 45 45 45 45 45 45 45 45 1 1 
1 1 1 1 1 0 0 0 0 0 0 0 0 0 1 1 45 45 45 45 45 45 45 45 1 1 
1 1 1 1 1 0 0 0 0 0 0 0 0 0 1 1 45 45 45 45 45 45 45 45 1 1 
1 1 1 1 1 0 0 0 0 0 0 0 0 0 5 1 45 45 45 45 45 45 45 45 1 1 
1 1 1 1 1 45 45 45 45 45 45 45 45 45 5 1 45 45 45 45 45 45 45 45 1 1 
1 1 1 1 1 0 0 0 0 0 0 0 0 0 5 1 45 45 45 45 45 45 45 45 1 1 
1 1 1 1 1 0 0 0 0 0 0 0 0 0 5 1 45 45 45 45 45 45 45 45 1 1 
1 1 1 1 1 0 0 0 0 0 0 0 0 0 5 1 1 1 1 1 1 1 1 1 1 1 
1 1 1 1 1 1 1 1 1 1 1 1 1 1 1 1 1 1 1 1 1 1 1 1 1 1 
f
p  12 5 2 0 
inventory  0 0 0 0 0 0 0 0 0 
t 0 
level 1
reflector 6 8 2 2
iceblock 9 10 1 0
iceblock 10 10 1 0
iceblock 11 10 1 0
iceblock 12 10 3 0
reflector 7 9 0 3
reflector 12 13 1 2
reflector 17 13 1 2
reflector 18 13 3 2
reflector 19 13 0 2
 lightbridge 8 4 2 0
 excursionfunnel 4 11 1 1
 lazer 4 8 1 0
 lazer 4 13 1 0
