22 21
1 1 1 1 1 1 1 1 1 1 1 1 1 1 1 1 1 1 1 1 1 
1 1 1 1 1 1 1 1 1 1 1 1 1 1 1 1 1 1 1 1 1 
1 1 1 1 1 1 1 1 1 1 1 1 1 1 1 1 1 1 1 1 1 
1 1 1 1 1 1 1 1 1 1 1 1 1 1 1 1 1 1 1 1 1 
1 1 1 1 1 1 1 1 1 1 1 1 1 1 1 1 1 1 1 1 1 
1 1 1 1 1 1 0 0 0 0 0 1 1 1 1 1 1 1 1 1 1 
1 1 1 1 1 1 0 1 1 1 0 1 0 0 0 0 0 0 1 1 1 
1 1 1 1 1 1 0 1 1 1 0 1 0 1 1 1 1 0 1 1 1 
1 1 1 1 1 1 0 1 1 0 0 1 0 1 1 1 1 0 1 1 1 
1 1 1 1 1 1 0 1 1 0 0 8 0 0 0 1 1 0 1 1 1 
1 1 1 1 1 1 0 0 0 0 0 0 0 0 0 0 0 0 1 1 1 
1 1 1 1 1 1 1 1 1 8 0 14 0 8 1 1 1 1 1 1 1 
1 1 1 1 1 0 0 0 0 0 0 0 0 0 0 0 0 1 1 1 1 
1 1 1 1 1 0 1 1 0 0 0 8 0 0 1 1 0 1 1 1 1 
1 1 1 1 1 0 1 1 1 1 0 1 0 0 1 1 0 1 1 1 1 
1 1 1 1 1 0 1 1 1 1 0 1 0 1 1 1 0 1 1 1 1 
1 1 1 1 1 0 0 0 0 0 0 1 0 1 1 1 0 1 1 1 1 
1 1 1 1 1 1 1 1 1 1 1 1 0 0 0 0 0 1 1 1 1 
1 1 1 1 1 1 1 1 1 1 1 1 1 1 1 1 1 1 1 1 1 
1 1 1 1 1 1 1 1 1 1 1 1 1 1 1 1 1 1 1 1 1 
1 1 1 1 1 1 1 1 1 1 1 1 1 1 1 1 1 1 1 1 1 
1 1 1 1 1 1 1 1 1 1 1 1 1 1 1 1 1 1 1 1 1 
f
p  11 11 2 0 
inventory  0 0 0 0 0 0 0 0 0 
t 0 
level 1
fireball 12 10 0 0
fireball 10 10 3 0
fireball 10 12 2 0
fireball 12 12 1 0
glider 12 14 0 0
glider 14 10 3 0
glider 10 8 2 0
glider 8 12 1 0
glider 14 17 1 0
glider 5 14 2 0
glider 8 5 3 0
glider 17 8 0 0
glider 16 13 0 0
glider 13 6 3 0
glider 6 9 2 0
glider 9 16 1 0
