18 18
1 1 1 1 1 1 1 1 1 1 1 1 1 1 1 1 1 1 
1 1 10 25 30 30 30 30 30 30 30 30 30 30 30 30 30 1 
1 1 1 1 1 1 1 1 1 1 1 1 1 1 1 1 30 1 
1 1 30 30 30 30 30 30 30 30 30 30 30 30 30 30 30 1 
1 1 30 1 1 1 1 1 1 1 1 1 1 1 1 1 1 1 
1 1 30 30 30 30 30 30 30 30 30 30 30 30 30 1 1 1 
1 1 1 1 1 1 1 1 1 1 1 1 1 1 30 1 1 1 
1 1 14 0 14 0 0 0 0 0 0 0 0 0 0 0 1 1 
1 1 14 30 14 14 14 14 14 14 14 14 14 14 14 14 1 1 
1 1 14 5 5 5 5 5 5 5 5 5 5 5 5 14 1 1 
1 1 14 5 5 5 5 5 5 5 5 5 5 5 5 14 1 1 
1 1 14 5 5 5 5 5 5 5 5 5 5 5 5 14 1 1 
1 1 14 5 5 5 5 5 5 5 5 5 5 5 5 14 1 1 
1 1 14 5 5 5 5 5 5 5 5 5 5 5 5 14 1 1 
1 1 14 5 5 5 5 5 5 5 5 5 5 5 5 14 1 1 
1 1 14 5 5 5 5 5 5 5 5 5 5 17 3 14 1 1 
1 1 14 14 14 14 14 14 14 14 14 14 14 14 14 14 1 1 
1 1 1 1 1 1 1 1 1 1 1 1 1 1 1 1 1 1 
f
p  14 7 2 0 
inventory  0 0 0 0 0 0 0 0 0 
t 0 
level 1
bug 3 7 2 0
