21 18
1 1 1 1 1 1 1 1 1 1 1 1 1 1 1 1 1 1 
1 1 0 0 0 1 1 1 0 0 0 0 0 0 0 0 0 1 
1 1 0 0 128 1 1 1 0 0 0 0 0 0 0 0 0 1 
1 1 0 0 0 1 1 1 0 0 0 1 1 1 1 0 0 1 
1 3 3 3 3 3 3 3 3 3 3 3 3 3 3 3 3 1 
1 1 0 0 0 1 1 1 1 3 3 3 1 1 3 3 3 1 
1 1 0 0 0 1 1 1 0 0 0 1 1 1 1 0 0 1 
1 1 0 0 0 0 0 0 0 0 0 1 1 0 0 0 0 1 
1 1 1 1 1 1 1 1 1 1 1 1 1 0 0 1 1 1 
1 3 3 0 3 3 3 3 3 3 3 3 1 0 0 1 1 1 
1 3 3 0 3 3 0 1 3 3 3 3 1 0 0 0 1 1 
1 3 3 3 3 1 0 0 3 3 0 1 3 3 3 3 3 1 
1 3 1 0 3 0 1 0 3 3 3 3 3 3 3 3 0 1 
1 3 8 0 3 3 3 3 3 1 0 3 3 3 3 0 3 1 
1 3 3 3 3 3 3 3 3 3 3 3 0 3 3 1 3 1 
1 3 3 3 1 0 3 0 1 3 3 1 0 3 3 3 0 1 
1 3 1 0 3 3 3 0 0 3 3 3 3 3 0 3 1 1 
1 0 3 3 3 3 8 0 3 3 0 3 3 0 1 3 3 1 
1 9 1 3 3 3 3 3 3 3 1 3 3 3 3 3 8 1 
1 10 1 3 3 3 3 1 0 3 3 3 0 3 3 3 0 1 
1 1 1 1 1 1 1 1 1 1 1 1 1 1 1 1 1 1 
f
p  2 2 2 0 
inventory  0 0 0 0 0 0 0 0 0 
t 0 
level 1
